//MAP CONVERTED BY dmm2tgm.py THIS HEADER COMMENT PREVENTS RECONVERSION, DO NOT REMOVE
"aa" = (
/turf/template_noop,
/area/template_noop)
"ab" = (
/turf/closed/mineral/random,
/area/ruin/unpowered/no_grav)
"as" = (
/obj/effect/decal/cleanable/dirt,
/obj/machinery/atmospherics/components/unary/vent_pump/on/layer3,
/turf/open/floor/plating,
/area/ruin/space/has_grav/listeningstation)
"aA" = (
/turf/open/floor/engine/hull{
	initial_gas_mix = "o2=22;n2=82;TEMP=293.15";
	name = "interior hull plating"
	},
/area/ruin/space/has_grav/listeningstation)
"bk" = (
/obj/machinery/atmospherics/pipe/simple/scrubbers/hidden/layer1{
	dir = 5
	},
/turf/closed/mineral/random,
/area/ruin/unpowered/no_grav)
"bq" = (
/obj/effect/decal/cleanable/dirt,
/obj/machinery/airalarm/syndicate/directional/north,
/turf/open/floor/iron,
/area/ruin/space/has_grav/listeningstation)
"bw" = (
/obj/machinery/door/airlock/external,
/obj/effect/mapping_helpers/airlock/cyclelink_helper{
	dir = 4
	},
/obj/effect/mapping_helpers/airlock/access/all/syndicate/general,
/obj/effect/decal/cleanable/dirt,
/turf/open/floor/plating,
/area/ruin/space/has_grav/listeningstation)
"bD" = (
/obj/docking_port/stationary{
	dir = 2;
	dwidth = 14;
	height = 13;
	id = "commsagent_home";
	name = "Resupply Outpost";
	roundstart_template = /datum/map_template/shuttle/ruin/syndicate_listening_ship;
	width = 22
	},
/turf/open/floor/engine/hull{
	initial_gas_mix = "o2=22;n2=82;TEMP=293.15";
	name = "interior hull plating"
	},
/area/ruin/space/has_grav/listeningstation)
"ct" = (
/obj/structure/railing,
/obj/effect/decal/cleanable/dirt,
/obj/machinery/atmospherics/pipe/simple/scrubbers/hidden/layer1{
	dir = 4
	},
/obj/machinery/atmospherics/pipe/simple/supply/hidden/layer3{
	dir = 4
	},
/turf/open/floor/iron,
/area/ruin/space/has_grav/listeningstation)
"dj" = (
/obj/structure/cable,
/obj/machinery/power/floodlight,
/obj/effect/decal/cleanable/dirt,
/turf/open/floor/iron,
/area/ruin/space/has_grav/listeningstation)
"eH" = (
/obj/effect/decal/cleanable/dirt,
/obj/effect/turf_decal/stripes/line{
	dir = 1
	},
/turf/open/floor/iron/dark,
/area/ruin/space/has_grav/listeningstation)
"eW" = (
/obj/machinery/door/airlock/hatch,
/obj/effect/mapping_helpers/airlock/access/all/syndicate/general,
/obj/machinery/door/firedoor,
/obj/machinery/atmospherics/pipe/simple/scrubbers/hidden/layer1,
/obj/machinery/atmospherics/pipe/simple/supply/hidden/layer3,
/obj/effect/decal/cleanable/dirt,
/turf/open/floor/mineral/plastitanium/red,
/area/ruin/space/has_grav/listeningstation)
"fG" = (
/obj/structure/railing{
	dir = 1
	},
/obj/effect/decal/cleanable/dirt,
/obj/machinery/light{
	dir = 4
	},
/turf/open/floor/iron,
/area/ruin/space/has_grav/listeningstation)
"fN" = (
/obj/effect/turf_decal/delivery,
/obj/structure/closet/crate{
	name = "food crate"
	},
/obj/item/reagent_containers/food/drinks/waterbottle/large{
	pixel_x = -5;
	pixel_y = 3
	},
/obj/item/reagent_containers/food/drinks/waterbottle/large{
	pixel_x = 2;
	pixel_y = 3
	},
/obj/item/reagent_containers/food/drinks/waterbottle/large{
	pixel_x = -2
	},
/obj/item/reagent_containers/food/drinks/waterbottle/large{
	pixel_x = 5
	},
/obj/item/reagent_containers/food/drinks/waterbottle/large{
	pixel_x = 1;
	pixel_y = -3
	},
/obj/item/reagent_containers/food/drinks/waterbottle/large{
	pixel_x = 8;
	pixel_y = -3
	},
/obj/effect/decal/cleanable/dirt,
/turf/open/floor/iron/dark,
/area/ruin/space/has_grav/listeningstation)
"gh" = (
/obj/effect/decal/cleanable/dirt,
/obj/effect/turf_decal/delivery,
/obj/machinery/computer/mech_bay_power_console,
/turf/open/floor/iron/dark,
/area/ruin/space/has_grav/listeningstation)
"hc" = (
/obj/structure/railing,
/obj/structure/cable,
/obj/effect/decal/cleanable/dirt,
/obj/machinery/atmospherics/pipe/simple/scrubbers/hidden/layer1{
	dir = 4
	},
/obj/machinery/atmospherics/pipe/simple/supply/hidden/layer3{
	dir = 4
	},
/turf/open/floor/iron,
/area/ruin/space/has_grav/listeningstation)
"hy" = (
/obj/structure/railing,
/turf/open/floor/iron,
/area/ruin/space/has_grav/listeningstation)
"io" = (
/obj/structure/table/reinforced,
/obj/machinery/button/door{
	id = "commsagent_hangar_door";
	req_access = list(150);
	name = "Hangar Doors"
	},
/obj/effect/decal/cleanable/dirt,
/turf/open/floor/mineral/plastitanium/red,
/area/ruin/space/has_grav/listeningstation)
"iv" = (
/obj/machinery/atmospherics/components/binary/valve/on/layer3,
/turf/open/floor/engine/hull{
	initial_gas_mix = "o2=22;n2=82;TEMP=293.15";
	name = "interior hull plating"
	},
/area/ruin/space/has_grav/listeningstation)
"iR" = (
/obj/effect/decal/cleanable/dirt,
/obj/effect/turf_decal/stripes/corner{
	dir = 1
	},
/turf/open/floor/iron/dark,
/area/ruin/space/has_grav/listeningstation)
"ja" = (
/obj/effect/decal/cleanable/dirt,
/obj/machinery/atmospherics/pipe/simple/scrubbers/hidden/layer1,
/obj/effect/turf_decal/stripes/line{
	dir = 1
	},
/turf/open/floor/iron/dark,
/area/ruin/space/has_grav/listeningstation)
"jg" = (
/obj/machinery/atmospherics/pipe/simple/scrubbers/hidden/layer1,
/obj/effect/decal/cleanable/dirt,
/turf/open/floor/iron,
/area/ruin/space/has_grav/listeningstation)
"jt" = (
/obj/machinery/light/dim{
	dir = 4
	},
/turf/open/floor/iron/dark,
/area/ruin/space/has_grav/listeningstation)
"jC" = (
/obj/effect/decal/cleanable/dirt,
/turf/open/floor/mineral/plastitanium/red,
/area/ruin/space/has_grav/listeningstation)
"jF" = (
/obj/structure/cable,
/obj/effect/decal/cleanable/dirt,
/obj/machinery/atmospherics/pipe/simple/scrubbers/hidden/layer1,
/obj/effect/turf_decal/stripes/line,
/turf/open/floor/iron,
/area/ruin/space/has_grav/listeningstation)
"ky" = (
/obj/structure/rack,
/obj/item/clothing/mask/gas/syndicate,
/obj/item/tank/internals/oxygen,
/obj/effect/decal/cleanable/dirt,
/turf/open/floor/plating,
/area/ruin/space/has_grav/listeningstation)
"kG" = (
/obj/effect/decal/cleanable/dirt,
/obj/machinery/firealarm/directional/south,
/turf/open/floor/iron/dark,
/area/ruin/space/has_grav/listeningstation)
"kV" = (
/obj/structure/railing/corner{
	dir = 4
	},
/obj/structure/cable,
/obj/machinery/atmospherics/pipe/simple/supply/hidden/layer3{
	dir = 5
	},
/obj/machinery/atmospherics/pipe/simple/scrubbers/hidden/layer1{
	dir = 5
	},
/turf/open/floor/iron,
/area/ruin/space/has_grav/listeningstation)
"ly" = (
/obj/item/flashlight/flare,
/obj/item/flashlight/flare,
/obj/item/flashlight/flare,
/obj/item/flashlight/flare,
/obj/item/flashlight/flare,
/obj/item/flashlight,
/obj/item/flashlight,
/obj/item/shovel,
/obj/item/pickaxe/drill,
/obj/item/pickaxe/drill,
/obj/effect/turf_decal/delivery,
/obj/effect/decal/cleanable/dirt,
/obj/machinery/atmospherics/pipe/simple/supply/hidden/layer3{
	dir = 4
	},
/obj/structure/closet/crate,
/turf/open/floor/iron/dark,
/area/ruin/space/has_grav/listeningstation)
"lI" = (
/obj/effect/decal/cleanable/dirt,
/obj/machinery/atmospherics/pipe/simple/scrubbers/hidden/layer1,
/obj/machinery/atmospherics/pipe/simple/supply/hidden/layer3,
/turf/open/floor/iron,
/area/ruin/space/has_grav/listeningstation)
"mC" = (
/obj/structure/railing{
	dir = 4
	},
/obj/structure/cable,
/obj/machinery/atmospherics/pipe/simple/supply/hidden/layer3,
/obj/effect/decal/cleanable/dirt,
/obj/machinery/atmospherics/pipe/simple/scrubbers/hidden/layer1,
/turf/open/floor/iron,
/area/ruin/space/has_grav/listeningstation)
"mE" = (
/obj/effect/decal/cleanable/dirt,
/obj/machinery/light/broken{
	dir = 8
	},
/turf/open/floor/iron/dark,
/area/ruin/space/has_grav/listeningstation)
"mN" = (
/obj/machinery/power/smes/engineering,
/obj/structure/cable,
/obj/effect/decal/cleanable/dirt,
/turf/open/floor/plating,
/area/ruin/space/has_grav/listeningstation)
"nf" = (
/obj/structure/railing{
	dir = 4
	},
/obj/structure/cable,
/obj/machinery/atmospherics/pipe/manifold/supply/hidden/layer3{
	dir = 4
	},
/obj/machinery/atmospherics/pipe/simple/scrubbers/hidden/layer1,
/turf/open/floor/iron,
/area/ruin/space/has_grav/listeningstation)
"nl" = (
/obj/structure/railing,
/obj/structure/cable,
/obj/effect/decal/cleanable/dirt,
/obj/machinery/atmospherics/pipe/manifold/supply/hidden/layer3,
/obj/machinery/atmospherics/pipe/manifold/scrubbers/hidden/layer1,
/turf/open/floor/iron,
/area/ruin/space/has_grav/listeningstation)
"nn" = (
/obj/effect/decal/cleanable/dirt,
/obj/machinery/firealarm/directional/west,
/turf/open/floor/plating,
/area/ruin/space/has_grav/listeningstation)
"oP" = (
/obj/machinery/power/terminal{
	dir = 4
	},
/obj/structure/cable,
/obj/effect/decal/cleanable/dirt,
/turf/open/floor/plating,
/area/ruin/space/has_grav/listeningstation)
"pq" = (
/turf/open/floor/iron,
/area/ruin/space/has_grav/listeningstation)
"qb" = (
/obj/structure/railing{
	dir = 1
	},
/obj/effect/decal/cleanable/dirt,
/obj/machinery/atmospherics/pipe/manifold/supply/hidden/layer3{
	dir = 1
	},
/obj/machinery/atmospherics/pipe/simple/scrubbers/hidden/layer1{
	dir = 4
	},
/turf/open/floor/iron,
/area/ruin/space/has_grav/listeningstation)
"qf" = (
/obj/structure/railing{
	dir = 1
	},
/obj/machinery/atmospherics/pipe/simple/scrubbers/hidden/layer1{
	dir = 4
	},
/obj/effect/decal/cleanable/dirt,
/turf/open/floor/iron,
/area/ruin/space/has_grav/listeningstation)
"qA" = (
/obj/structure/railing,
/obj/effect/decal/cleanable/dirt,
/obj/machinery/atmospherics/pipe/simple/scrubbers/hidden/layer1{
	dir = 9
	},
/obj/machinery/atmospherics/pipe/simple/supply/hidden/layer3{
	dir = 9
	},
/turf/open/floor/iron,
/area/ruin/space/has_grav/listeningstation)
"qG" = (
/obj/machinery/atmospherics/components/unary/outlet_injector/on/layer1{
	dir = 8
	},
/turf/open/floor/plating/airless,
/area/ruin/space/has_grav/listeningstation)
"rj" = (
/obj/structure/cable,
/turf/closed/wall/r_wall,
/area/ruin/space/has_grav/listeningstation)
"rM" = (
/obj/effect/decal/cleanable/dirt,
/obj/machinery/atmospherics/pipe/simple/supply/hidden/layer3{
	dir = 5
	},
/turf/open/floor/iron/dark,
/area/ruin/space/has_grav/listeningstation)
"su" = (
/obj/structure/closet/crate/engineering/electrical,
/obj/item/storage/toolbox/electrical,
/obj/item/stock_parts/cell/hyper,
/obj/item/stock_parts/cell/high,
/obj/effect/turf_decal/delivery,
/turf/open/floor/iron/dark,
/area/ruin/space/has_grav/listeningstation)
"tt" = (
/obj/structure/table/reinforced,
/obj/effect/decal/cleanable/dirt,
/turf/open/floor/mineral/plastitanium/red,
/area/ruin/space/has_grav/listeningstation)
"uh" = (
/obj/effect/turf_decal/delivery,
/obj/item/reagent_containers/food/snacks/canned/beans{
	pixel_x = -5;
	pixel_y = 3
	},
/obj/item/reagent_containers/food/snacks/canned/beans{
	pixel_x = 2;
	pixel_y = 3
	},
/obj/item/reagent_containers/food/snacks/canned/beans{
	pixel_x = -2
	},
/obj/item/reagent_containers/food/snacks/canned/beans{
	pixel_x = 5
	},
/obj/item/reagent_containers/food/snacks/canned/beans{
	pixel_x = 1;
	pixel_y = -3
	},
/obj/item/reagent_containers/food/snacks/canned/beans{
	pixel_x = 8;
	pixel_y = -3
	},
/obj/structure/closet/crate{
	name = "food crate"
	},
/obj/effect/decal/cleanable/dirt,
/obj/machinery/atmospherics/pipe/simple/scrubbers/hidden/layer1{
	dir = 4
	},
/obj/item/pizzabox/margherita,
/turf/open/floor/iron/dark,
/area/ruin/space/has_grav/listeningstation)
"uj" = (
/obj/effect/decal/cleanable/dirt,
/obj/machinery/atmospherics/pipe/simple/scrubbers/hidden/layer1,
/turf/open/floor/iron/dark,
/area/ruin/space/has_grav/listeningstation)
"ur" = (
/obj/effect/turf_decal/delivery,
/obj/item/reagent_containers/food/snacks/canned/beans{
	pixel_x = -5;
	pixel_y = 3
	},
/obj/item/reagent_containers/food/snacks/canned/beans{
	pixel_x = 2;
	pixel_y = 3
	},
/obj/item/reagent_containers/food/snacks/canned/beans{
	pixel_x = -2
	},
/obj/item/reagent_containers/food/snacks/canned/beans{
	pixel_x = 5
	},
/obj/item/reagent_containers/food/snacks/canned/beans{
	pixel_x = 1;
	pixel_y = -3
	},
/obj/item/reagent_containers/food/snacks/canned/beans{
	pixel_x = 8;
	pixel_y = -3
	},
/obj/structure/closet/crate{
	name = "food crate"
	},
/obj/effect/decal/cleanable/dirt,
/obj/item/pizzabox/margherita,
/turf/open/floor/iron/dark,
/area/ruin/space/has_grav/listeningstation)
"vp" = (
/obj/effect/decal/cleanable/dirt,
/obj/machinery/atmospherics/pipe/simple/supply/hidden/layer3,
/turf/open/floor/iron/dark,
/area/ruin/space/has_grav/listeningstation)
"vx" = (
/obj/effect/decal/cleanable/dirt,
/obj/machinery/firealarm/directional/north,
/turf/open/floor/iron,
/area/ruin/space/has_grav/listeningstation)
"wn" = (
/obj/effect/decal/cleanable/dirt,
/obj/effect/turf_decal/delivery,
/obj/effect/spawner/lootdrop/whiteship_cere_ripley,
/turf/open/floor/iron/dark,
/area/ruin/space/has_grav/listeningstation)
"wB" = (
/obj/machinery/door/poddoor/shutters{
	id = "commsagent_hangar_warehouse"
	},
/obj/machinery/door/firedoor,
/turf/open/floor/iron/dark,
/area/ruin/space/has_grav/listeningstation)
"wR" = (
/obj/effect/decal/cleanable/dirt,
/turf/open/floor/iron,
/area/ruin/space/has_grav/listeningstation)
"yt" = (
/obj/effect/decal/cleanable/dirt,
/obj/machinery/atmospherics/pipe/simple/supply/hidden/layer3,
/obj/effect/turf_decal/stripes/line{
	dir = 1
	},
/turf/open/floor/iron/dark,
/area/ruin/space/has_grav/listeningstation)
"zK" = (
/obj/structure/railing/corner{
	dir = 4
	},
/obj/structure/railing/corner{
	dir = 1
	},
/obj/machinery/atmospherics/pipe/simple/supply/hidden/layer3{
	dir = 4
	},
/obj/effect/decal/cleanable/dirt,
/obj/machinery/atmospherics/pipe/simple/scrubbers/hidden/layer1{
	dir = 4
	},
/turf/open/floor/iron,
/area/ruin/space/has_grav/listeningstation)
"Aa" = (
/obj/effect/decal/cleanable/dirt,
/obj/effect/turf_decal/delivery,
/obj/machinery/mech_bay_recharge_port{
	dir = 1
	},
/turf/open/floor/iron/dark,
/area/ruin/space/has_grav/listeningstation)
"An" = (
/obj/structure/cable,
/obj/machinery/atmospherics/pipe/simple/supply/hidden/layer3,
/obj/effect/decal/cleanable/dirt,
/obj/machinery/atmospherics/pipe/simple/scrubbers/hidden/layer1,
/turf/open/floor/iron,
/area/ruin/space/has_grav/listeningstation)
"Aq" = (
/obj/machinery/power/rtg/advanced,
/obj/structure/cable,
/obj/effect/decal/cleanable/dirt,
/obj/machinery/airalarm/syndicate/directional/north,
/turf/open/floor/plating,
/area/ruin/space/has_grav/listeningstation)
"Bc" = (
/obj/effect/decal/cleanable/dirt,
/obj/machinery/atmospherics/components/unary/vent_pump/on/layer3{
	dir = 8
	},
/turf/open/floor/iron/dark,
/area/ruin/space/has_grav/listeningstation)
"CU" = (
/obj/structure/railing,
/obj/machinery/atmospherics/pipe/simple/supply/hidden/layer3{
	dir = 4
	},
/obj/effect/decal/cleanable/dirt,
/obj/machinery/atmospherics/pipe/simple/scrubbers/hidden/layer1{
	dir = 4
	},
/turf/open/floor/iron,
/area/ruin/space/has_grav/listeningstation)
"DN" = (
/obj/effect/decal/cleanable/dirt,
/obj/machinery/atmospherics/pipe/manifold/supply/hidden/layer3{
	dir = 8
	},
/obj/machinery/atmospherics/components/unary/vent_scrubber/on/layer1,
/turf/open/floor/plating,
/area/ruin/space/has_grav/listeningstation)
"Es" = (
/obj/structure/cable,
/obj/effect/decal/cleanable/dirt,
/turf/open/floor/iron,
/area/ruin/space/has_grav/listeningstation)
"Ex" = (
/obj/machinery/power/rtg/advanced,
/obj/structure/cable,
/obj/effect/decal/cleanable/dirt,
/turf/open/floor/plating,
/area/ruin/space/has_grav/listeningstation)
"EJ" = (
/obj/machinery/airalarm/syndicate/directional/south,
/turf/open/floor/iron/dark,
/area/ruin/space/has_grav/listeningstation)
"FI" = (
/obj/structure/railing{
	dir = 4
	},
/obj/structure/cable,
/obj/machinery/atmospherics/pipe/simple/supply/hidden/layer3,
/obj/machinery/atmospherics/pipe/manifold/scrubbers/hidden/layer1{
	dir = 4
	},
/turf/open/floor/iron,
/area/ruin/space/has_grav/listeningstation)
"FM" = (
/turf/open/floor/iron/dark,
/area/ruin/space/has_grav/listeningstation)
"FQ" = (
/obj/machinery/atmospherics/pipe/simple/supply/hidden/layer3,
/turf/open/floor/engine/hull{
	initial_gas_mix = "o2=22;n2=82;TEMP=293.15";
	name = "interior hull plating"
	},
/area/ruin/space/has_grav/listeningstation)
"Gw" = (
/obj/machinery/door/poddoor/shutters{
	id = "commsagent_hangar_warehouse"
	},
/obj/machinery/door/firedoor,
/obj/machinery/atmospherics/pipe/simple/supply/hidden/layer3,
/turf/open/floor/iron/dark,
/area/ruin/space/has_grav/listeningstation)
"GH" = (
/obj/machinery/door/airlock/external,
/obj/effect/mapping_helpers/airlock/cyclelink_helper{
	dir = 8
	},
/obj/effect/mapping_helpers/airlock/access/all/syndicate/general,
/obj/effect/decal/cleanable/dirt,
/turf/open/floor/plating,
/area/ruin/space/has_grav/listeningstation)
"Hm" = (
/obj/machinery/firealarm/directional/north,
/obj/effect/decal/cleanable/dirt,
/turf/open/floor/mineral/plastitanium/red,
/area/ruin/space/has_grav/listeningstation)
"Hn" = (
/obj/structure/cable,
/obj/machinery/atmospherics/pipe/layer_manifold{
	dir = 4
	},
/obj/effect/decal/cleanable/dirt,
/turf/open/floor/plating,
/area/ruin/space/has_grav/listeningstation)
"Ib" = (
/obj/structure/cable,
/obj/machinery/power/apc/auto_name/north,
/obj/effect/decal/cleanable/dirt,
/turf/open/floor/iron,
/area/ruin/space/has_grav/listeningstation)
"IP" = (
/obj/structure/railing/corner{
	dir = 8
	},
/obj/structure/railing/corner,
/obj/structure/cable,
/obj/effect/decal/cleanable/dirt,
/obj/machinery/atmospherics/pipe/simple/scrubbers/hidden/layer1{
	dir = 4
	},
/obj/machinery/atmospherics/pipe/simple/supply/hidden/layer3{
	dir = 4
	},
/turf/open/floor/iron,
/area/ruin/space/has_grav/listeningstation)
"Jb" = (
/obj/structure/railing{
	dir = 1
	},
/obj/machinery/atmospherics/pipe/simple/supply/hidden/layer3{
	dir = 4
	},
/obj/effect/decal/cleanable/dirt,
/obj/machinery/atmospherics/pipe/manifold/scrubbers/hidden/layer1{
	dir = 1
	},
/turf/open/floor/iron,
/area/ruin/space/has_grav/listeningstation)
"Je" = (
/obj/structure/cable,
/obj/effect/decal/cleanable/dirt,
/obj/machinery/button/door{
	id = "commsagent_hangar_warehouse";
	name = "Hangar Warehouse";
	req_access = list(150);
	pixel_y = -24
	},
/obj/effect/turf_decal/stripes/corner,
/turf/open/floor/iron,
/area/ruin/space/has_grav/listeningstation)
"Jf" = (
/obj/structure/closet/crate/radiation,
/obj/item/clothing/head/radiation,
/obj/item/clothing/suit/radiation,
/obj/item/geiger_counter,
/obj/effect/turf_decal/delivery,
/turf/open/floor/iron/dark,
/area/ruin/space/has_grav/listeningstation)
"JU" = (
/obj/structure/railing,
/obj/machinery/light{
	dir = 4
	},
/turf/open/floor/iron,
/area/ruin/space/has_grav/listeningstation)
"Kt" = (
/obj/effect/decal/cleanable/dirt,
/obj/machinery/atmospherics/components/unary/vent_scrubber/on/layer1{
	dir = 4
	},
/turf/open/floor/iron,
/area/ruin/space/has_grav/listeningstation)
"KI" = (
/turf/closed/wall/r_wall,
/area/ruin/space/has_grav/listeningstation)
"KM" = (
/obj/structure/railing{
	dir = 1
	},
/obj/machinery/atmospherics/pipe/simple/supply/hidden/layer3{
	dir = 9
	},
/obj/machinery/atmospherics/pipe/simple/scrubbers/hidden/layer1{
	dir = 4
	},
/obj/effect/decal/cleanable/dirt,
/turf/open/floor/iron,
/area/ruin/space/has_grav/listeningstation)
"Mg" = (
/obj/machinery/atmospherics/pipe/simple/scrubbers/hidden/layer1,
/obj/machinery/atmospherics/pipe/simple/supply/hidden/layer3,
/obj/effect/decal/cleanable/dirt,
/turf/open/floor/mineral/plastitanium/red,
/area/ruin/space/has_grav/listeningstation)
"Mi" = (
/obj/structure/fans/tiny,
/obj/machinery/door/poddoor{
	id = "commsagent_hangar_door"
	},
/turf/open/floor/plating,
/area/ruin/space/has_grav/listeningstation)
"Mn" = (
/obj/machinery/door/airlock/maintenance_hatch,
/obj/effect/mapping_helpers/airlock/access/all/syndicate/general,
/obj/structure/cable,
/obj/machinery/atmospherics/pipe/simple/supply/hidden/layer3,
/obj/machinery/door/firedoor,
/obj/machinery/atmospherics/pipe/simple/scrubbers/hidden/layer1,
/turf/open/floor/plating,
/area/ruin/space/has_grav/listeningstation)
"Mp" = (
/obj/structure/railing/corner,
/obj/structure/cable,
/obj/machinery/atmospherics/pipe/simple/supply/hidden/layer3{
	dir = 6
	},
/obj/machinery/atmospherics/pipe/simple/scrubbers/hidden/layer1{
	dir = 6
	},
/turf/open/floor/iron,
/area/ruin/space/has_grav/listeningstation)
"MJ" = (
/obj/structure/railing{
	dir = 4
	},
/obj/structure/cable,
/obj/machinery/atmospherics/pipe/simple/supply/hidden/layer3,
/obj/machinery/atmospherics/pipe/simple/scrubbers/hidden/layer1,
/turf/open/floor/iron,
/area/ruin/space/has_grav/listeningstation)
"MS" = (
/obj/structure/railing{
	dir = 1
	},
/obj/machinery/atmospherics/pipe/simple/supply/hidden/layer3{
	dir = 4
	},
/obj/machinery/atmospherics/pipe/simple/scrubbers/hidden/layer1{
	dir = 4
	},
/obj/effect/decal/cleanable/dirt,
/turf/open/floor/iron,
/area/ruin/space/has_grav/listeningstation)
"Nb" = (
/obj/machinery/atmospherics/pipe/simple/supply/hidden/layer3{
	dir = 4
	},
/obj/effect/decal/cleanable/dirt,
/turf/open/floor/plating,
/area/ruin/space/has_grav/listeningstation)
"NB" = (
/obj/effect/decal/cleanable/dirt,
/obj/machinery/atmospherics/components/unary/vent_scrubber/on/layer1{
	dir = 4
	},
/turf/open/floor/iron/dark,
/area/ruin/space/has_grav/listeningstation)
"Pt" = (
/obj/machinery/atmospherics/components/unary/vent_scrubber/on/layer1,
/turf/open/floor/mineral/plastitanium/red,
/area/ruin/space/has_grav/listeningstation)
"Qu" = (
/obj/structure/cable,
/obj/effect/decal/cleanable/dirt,
/obj/machinery/atmospherics/pipe/simple/supply/hidden/layer3,
/obj/effect/turf_decal/stripes/line,
/turf/open/floor/iron,
/area/ruin/space/has_grav/listeningstation)
"QE" = (
/obj/structure/cable,
/turf/open/floor/iron,
/area/ruin/space/has_grav/listeningstation)
"QZ" = (
/obj/effect/decal/cleanable/dirt,
/obj/machinery/light/dim{
	dir = 4
	},
/turf/open/floor/mineral/plastitanium/red,
/area/ruin/space/has_grav/listeningstation)
"Rw" = (
/obj/effect/decal/cleanable/dirt,
/turf/open/floor/engine/hull{
	initial_gas_mix = "o2=22;n2=82;TEMP=293.15";
	name = "interior hull plating"
	},
/area/ruin/space/has_grav/listeningstation)
"SM" = (
/obj/structure/cable,
/obj/effect/decal/cleanable/dirt,
/obj/machinery/firealarm/directional/south,
/obj/effect/turf_decal/stripes/corner{
	dir = 8
	},
/turf/open/floor/iron,
/area/ruin/space/has_grav/listeningstation)
"Te" = (
/obj/effect/decal/cleanable/dirt,
/turf/open/floor/plating,
/area/ruin/space/has_grav/listeningstation)
"Tk" = (
/turf/open/floor/mineral/plastitanium/red,
/area/ruin/space/has_grav/listeningstation)
"Tp" = (
/obj/machinery/atmospherics/pipe/simple/scrubbers/hidden/layer1,
/obj/machinery/atmospherics/components/unary/vent_pump/on/layer3,
/obj/effect/decal/cleanable/dirt,
/turf/open/floor/mineral/plastitanium/red,
/area/ruin/space/has_grav/listeningstation)
"Vf" = (
/obj/effect/decal/cleanable/dirt,
/turf/open/floor/iron/dark,
/area/ruin/space/has_grav/listeningstation)
"Vg" = (
/obj/structure/railing{
	dir = 1
	},
/obj/machinery/atmospherics/pipe/simple/supply/hidden/layer3{
	dir = 4
	},
/obj/effect/decal/cleanable/dirt,
/obj/machinery/atmospherics/pipe/simple/scrubbers/hidden/layer1{
	dir = 4
	},
/turf/open/floor/iron,
/area/ruin/space/has_grav/listeningstation)
"VG" = (
/obj/structure/cable,
/obj/effect/decal/cleanable/dirt,
/obj/effect/turf_decal/stripes/line,
/turf/open/floor/iron,
/area/ruin/space/has_grav/listeningstation)
"Xu" = (
/obj/effect/decal/cleanable/dirt,
/obj/machinery/light/broken{
	dir = 8
	},
/turf/open/floor/plating,
/area/ruin/space/has_grav/listeningstation)
"XH" = (
/obj/effect/decal/cleanable/dirt,
/obj/machinery/button/door{
	id = "commsagent_hangar_warehouse";
	name = "Hangar Warehouse";
	req_access = list(150);
	pixel_y = 24
	},
/obj/effect/turf_decal/stripes/corner{
	dir = 4
	},
/turf/open/floor/iron/dark,
/area/ruin/space/has_grav/listeningstation)
"XM" = (
/obj/structure/railing{
	dir = 1
	},
/obj/machinery/atmospherics/pipe/simple/scrubbers/hidden/layer1{
	dir = 10
	},
/obj/effect/decal/cleanable/dirt,
/turf/open/floor/iron,
/area/ruin/space/has_grav/listeningstation)
"Yt" = (
/obj/effect/decal/cleanable/dirt,
/obj/machinery/atmospherics/pipe/simple/scrubbers/hidden/layer1{
	dir = 9
	},
/turf/open/floor/iron/dark,
/area/ruin/space/has_grav/listeningstation)
"YM" = (
/obj/machinery/suit_storage_unit/open,
/obj/effect/decal/cleanable/dirt,
/turf/open/floor/plating,
/area/ruin/space/has_grav/listeningstation)
"YR" = (
/obj/machinery/atmospherics/components/unary/tank/air{
	dir = 8
	},
/obj/effect/decal/cleanable/dirt,
/turf/open/floor/plating,
/area/ruin/space/has_grav/listeningstation)
"Zg" = (
/obj/machinery/door/poddoor/shutters{
	id = "commsagent_hangar_warehouse"
	},
/obj/machinery/door/firedoor,
/obj/machinery/atmospherics/pipe/simple/scrubbers/hidden/layer1,
/turf/open/floor/iron/dark,
/area/ruin/space/has_grav/listeningstation)
"Zq" = (
/obj/structure/railing{
	dir = 1
	},
/obj/machinery/atmospherics/pipe/simple/supply/hidden/layer3{
	dir = 4
	},
/obj/machinery/atmospherics/pipe/simple/scrubbers/hidden/layer1{
	dir = 4
	},
/turf/open/floor/iron,
/area/ruin/space/has_grav/listeningstation)
"Zu" = (
/obj/machinery/atmospherics/pipe/simple/scrubbers/hidden/layer1,
/turf/closed/wall/r_wall,
/area/ruin/space/has_grav/listeningstation)

(1,1,1) = {"
aa
aa
aa
aa
aa
aa
aa
aa
aa
aa
aa
aa
aa
aa
aa
aa
ab
ab
ab
ab
ab
aa
aa
aa
aa
aa
aa
aa
aa
aa
aa
aa
aa
aa
aa
aa
aa
aa
"}
(2,1,1) = {"
aa
aa
aa
aa
aa
aa
ab
ab
ab
ab
ab
aa
aa
aa
ab
ab
ab
ab
ab
ab
ab
ab
ab
ab
ab
aa
aa
aa
aa
aa
aa
aa
aa
aa
aa
aa
aa
aa
"}
(3,1,1) = {"
aa
aa
aa
aa
aa
ab
ab
ab
ab
ab
ab
ab
aa
ab
ab
ab
ab
ab
ab
ab
ab
ab
ab
ab
ab
ab
ab
ab
ab
ab
aa
ab
ab
ab
aa
aa
aa
aa
"}
(4,1,1) = {"
aa
aa
aa
aa
ab
ab
ab
ab
ab
ab
ab
ab
ab
ab
ab
ab
ab
ab
ab
ab
ab
ab
ab
ab
ab
ab
ab
ab
ab
ab
ab
ab
ab
ab
ab
aa
aa
aa
"}
(5,1,1) = {"
aa
aa
aa
ab
ab
ab
ab
ab
ab
ab
ab
ab
ab
ab
ab
ab
ab
ab
ab
ab
ab
ab
ab
ab
ab
ab
ab
ab
ab
ab
ab
ab
ab
ab
ab
aa
aa
aa
"}
(6,1,1) = {"
aa
aa
aa
ab
ab
ab
ab
ab
KI
KI
KI
KI
KI
KI
KI
KI
KI
KI
KI
KI
KI
KI
KI
KI
KI
KI
KI
ab
ab
ab
ab
ab
ab
ab
ab
ab
ab
aa
"}
(7,1,1) = {"
aa
aa
ab
ab
ab
ab
ab
ab
KI
wR
pq
pq
pq
pq
pq
pq
wR
wR
wR
wR
Kt
wR
Kt
wR
pq
pq
KI
ab
ab
ab
ab
ab
ab
ab
ab
ab
ab
aa
"}
(8,1,1) = {"
aa
aa
ab
ab
KI
KI
KI
KI
KI
Es
Mp
MJ
nf
MJ
nf
MJ
MJ
MJ
MJ
MJ
FI
MJ
FI
mC
kV
QE
KI
ab
ab
ab
ab
ab
ab
ab
ab
ab
ab
aa
"}
(9,1,1) = {"
aa
aa
ab
ab
KI
Ex
Xu
nn
KI
Ib
CU
aA
aA
aA
aA
aA
aA
aA
aA
aA
aA
aA
aA
Rw
Vg
QE
KI
ab
ab
ab
ab
ab
ab
ab
ab
ab
ab
aa
"}
(10,1,1) = {"
aa
aa
aa
ab
KI
Aq
as
DN
Mn
An
nl
aA
aA
aA
aA
aA
aA
aA
aA
aA
aA
aA
aA
aA
Vg
QE
KI
KI
KI
KI
KI
KI
KI
ab
ab
ab
ab
aa
"}
(11,1,1) = {"
aa
aa
aa
ab
KI
Ex
oP
Nb
rj
wR
hc
aA
aA
aA
aA
aA
aA
aA
aA
aA
aA
aA
aA
aA
Vg
Es
KI
Vf
Vf
mE
FM
FM
KI
ab
ab
ab
aa
aa
"}
(12,1,1) = {"
aa
aa
aa
ab
KI
KI
mN
Hn
rj
wR
hc
aA
aA
aA
aA
aA
aA
aA
aA
aA
aA
aA
aA
aA
Zq
Je
KI
XH
fN
fN
fN
FM
KI
ab
ab
ab
aa
aa
"}
(13,1,1) = {"
aa
aa
aa
ab
ab
KI
KI
YR
KI
wR
hc
aA
aA
aA
aA
aA
aA
aA
aA
aA
aA
aA
aA
aA
Vg
VG
wB
eH
Vf
NB
Vf
Vf
KI
ab
ab
ab
ab
aa
"}
(14,1,1) = {"
aa
aa
aa
ab
ab
ab
KI
KI
KI
wR
hc
aA
aA
aA
aA
aA
aA
aA
aA
aA
aA
aA
aA
aA
Vg
VG
wB
eH
ur
uh
ur
Vf
KI
ab
ab
ab
ab
aa
"}
(15,1,1) = {"
aa
aa
aa
ab
ab
ab
ab
ab
KI
pq
hc
aA
aA
aA
aA
aA
aA
aA
aA
aA
aA
aA
aA
aA
Jb
jF
Zg
ja
uj
Yt
Vf
kG
KI
ab
ab
ab
ab
aa
"}
(16,1,1) = {"
aa
aa
aa
ab
ab
ab
ab
ab
KI
wR
hc
aA
aA
aA
aA
aA
aA
aA
aA
aA
aA
aA
aA
aA
qb
Qu
Gw
yt
vp
rM
Vf
EJ
KI
ab
ab
ab
ab
aa
"}
(17,1,1) = {"
aa
aa
ab
ab
ab
ab
ab
ab
KI
wR
IP
bD
aA
aA
aA
aA
aA
aA
aA
aA
aA
aA
aA
aA
zK
VG
wB
eH
su
ly
Jf
Vf
KI
ab
ab
ab
ab
aa
"}
(18,1,1) = {"
aa
ab
ab
ab
ab
ab
ab
ab
KI
pq
hc
aA
aA
aA
aA
aA
aA
aA
aA
aA
aA
aA
aA
aA
Vg
VG
wB
eH
Vf
Bc
Vf
Vf
KI
ab
ab
ab
ab
aa
"}
(19,1,1) = {"
aa
ab
ab
ab
ab
ab
ab
ab
KI
wR
hc
aA
aA
aA
aA
aA
aA
aA
aA
aA
aA
aA
aA
aA
Vg
SM
KI
iR
wn
Aa
gh
Vf
KI
ab
ab
ab
ab
aa
"}
(20,1,1) = {"
ab
ab
ab
ab
ab
ab
ab
ab
KI
dj
hc
aA
aA
aA
aA
aA
aA
aA
aA
aA
aA
aA
aA
aA
MS
dj
KI
Vf
Vf
jt
Vf
Vf
KI
ab
ab
ab
ab
ab
"}
(21,1,1) = {"
ab
ab
ab
ab
ab
ab
ab
ab
KI
wR
ct
aA
aA
aA
aA
aA
aA
aA
aA
aA
aA
aA
aA
aA
MS
wR
KI
KI
KI
KI
KI
KI
KI
ab
ab
ab
ab
ab
"}
(22,1,1) = {"
ab
ab
ab
ab
ab
ab
ab
ab
KI
wR
ct
aA
aA
aA
aA
aA
aA
aA
aA
aA
aA
aA
aA
aA
MS
wR
KI
ab
ab
ab
ab
ab
ab
ab
ab
ab
ab
ab
"}
(23,1,1) = {"
aa
ab
ab
KI
KI
KI
KI
KI
KI
wR
ct
aA
aA
aA
aA
aA
aA
aA
aA
aA
aA
aA
aA
aA
MS
wR
KI
ab
ab
ab
ab
ab
ab
ab
ab
ab
ab
ab
"}
(24,1,1) = {"
aa
ab
ab
KI
tt
io
tt
tt
KI
bq
ct
aA
aA
aA
aA
aA
aA
aA
aA
aA
aA
aA
aA
aA
MS
wR
KI
ab
ab
ab
ab
ab
ab
ab
ab
ab
ab
ab
"}
(25,1,1) = {"
aa
ab
ab
KI
Hm
Pt
Tp
Mg
eW
lI
qA
aA
aA
aA
aA
aA
aA
aA
aA
aA
aA
iv
FQ
FQ
KM
wR
KI
ab
ab
ab
ab
ab
ab
ab
ab
ab
ab
aa
"}
(26,1,1) = {"
aa
ab
ab
KI
jC
QZ
Tk
Tk
KI
vx
hy
aA
aA
aA
aA
aA
aA
aA
aA
aA
aA
aA
aA
aA
qf
wR
KI
ab
ab
ab
ab
ab
ab
aa
aa
aa
aa
aa
"}
(27,1,1) = {"
aa
aa
ab
KI
KI
KI
bw
KI
KI
wR
hy
aA
aA
aA
aA
aA
aA
aA
aA
aA
aA
aA
aA
aA
qf
wR
KI
ab
ab
ab
ab
ab
aa
aa
aa
aa
aa
aa
"}
(28,1,1) = {"
aa
aa
aa
aa
ab
KI
Te
ky
KI
pq
hy
aA
aA
aA
aA
aA
aA
aA
aA
aA
aA
aA
aA
aA
qf
wR
KI
ab
ab
ab
ab
aa
aa
aa
aa
aa
aa
aa
"}
(29,1,1) = {"
aa
aa
aa
aa
aa
KI
Te
YM
KI
pq
hy
aA
aA
aA
aA
aA
aA
aA
aA
aA
aA
aA
aA
aA
XM
jg
Zu
bk
ab
aa
aa
aa
aa
aa
aa
aa
aa
aa
"}
(30,1,1) = {"
aa
aa
aa
aa
aa
KI
GH
KI
KI
pq
JU
aA
aA
aA
aA
aA
aA
aA
aA
aA
aA
aA
aA
aA
fG
wR
KI
qG
aa
aa
aa
aa
aa
aa
aa
aa
aa
aa
"}
(31,1,1) = {"
aa
aa
aa
aa
aa
aa
aa
ab
KI
KI
KI
aA
aA
aA
aA
aA
aA
aA
aA
aA
aA
aA
aA
aA
KI
KI
KI
aa
aa
aa
aa
aa
aa
aa
aa
aa
aa
aa
"}
(32,1,1) = {"
aa
aa
aa
aa
aa
aa
aa
aa
aa
aa
KI
Mi
Mi
Mi
Mi
Mi
Mi
Mi
Mi
Mi
Mi
Mi
Mi
Mi
KI
aa
aa
aa
aa
aa
aa
aa
aa
aa
aa
aa
aa
aa
"}
