//MAP CONVERTED BY dmm2tgm.py THIS HEADER COMMENT PREVENTS RECONVERSION, DO NOT REMOVE
"aa" = (
/turf/template_noop,
/area/template_noop)
"ab" = (
/turf/closed/mineral/random,
/area/ruin/unpowered/no_grav)
"al" = (
/obj/machinery/door/poddoor/shutters{
	id = "commsagent_hangar_warehouse"
	},
/obj/machinery/door/firedoor,
/obj/machinery/atmospherics/pipe/simple/scrubbers/hidden/layer1,
/turf/open/floor/iron/dark,
/area/ruin/space/has_grav/listeningstation)
"aA" = (
/turf/open/floor/engine/hull{
	initial_gas_mix = "o2=22;n2=82;TEMP=293.15";
	name = "interior hull plating"
	},
/area/ruin/space/has_grav/listeningstation)
"bk" = (
/obj/machinery/atmospherics/pipe/simple/scrubbers/hidden/layer1{
	dir = 5
	},
/turf/closed/mineral/random,
/area/ruin/unpowered/no_grav)
"bl" = (
/obj/structure/cable,
/obj/effect/decal/cleanable/dirt,
/obj/machinery/firealarm/directional/south,
/obj/effect/turf_decal/stripes/corner{
	dir = 8
	},
/turf/open/floor/iron,
/area/ruin/space/has_grav/listeningstation)
"bx" = (
/obj/structure/table/reinforced,
/obj/machinery/button/door{
	id = "commsagent_hangar_door";
	req_access = list(150);
	name = "Hangar Doors"
	},
/obj/effect/decal/cleanable/dirt,
/turf/open/floor/mineral/plastitanium/red,
/area/ruin/space/has_grav/listeningstation)
"bD" = (
/obj/docking_port/stationary{
	dir = 2;
	dwidth = 14;
	height = 13;
	id = "commsagent_home";
	name = "Resupply Outpost";
	roundstart_template = /datum/map_template/shuttle/ruin/syndicate_listening_ship;
	width = 22
	},
/turf/open/floor/engine/hull{
	initial_gas_mix = "o2=22;n2=82;TEMP=293.15";
	name = "interior hull plating"
	},
/area/ruin/space/has_grav/listeningstation)
"bU" = (
/obj/machinery/suit_storage_unit/open,
/obj/effect/decal/cleanable/dirt,
/turf/open/floor/plating,
/area/ruin/space/has_grav/listeningstation)
"ca" = (
/obj/effect/decal/cleanable/dirt,
/obj/effect/turf_decal/delivery,
/obj/machinery/computer/mech_bay_power_console,
/turf/open/floor/iron/dark,
/area/ruin/space/has_grav/listeningstation)
"cm" = (
/obj/effect/decal/cleanable/dirt,
/obj/machinery/light/dim{
	dir = 4
	},
/turf/open/floor/mineral/plastitanium/red,
/area/ruin/space/has_grav/listeningstation)
"cE" = (
/obj/structure/railing{
	dir = 1
	},
/obj/machinery/atmospherics/pipe/simple/supply/hidden/layer3{
	dir = 4
	},
/obj/machinery/atmospherics/pipe/simple/scrubbers/hidden/layer1{
	dir = 4
	},
/obj/effect/decal/cleanable/dirt,
/turf/open/floor/iron,
/area/ruin/space/has_grav/listeningstation)
"db" = (
/obj/machinery/light/dim{
	dir = 4
	},
/turf/open/floor/iron/dark,
/area/ruin/space/has_grav/listeningstation)
"dj" = (
/obj/structure/cable,
/obj/machinery/power/floodlight,
/obj/effect/decal/cleanable/dirt,
/turf/open/floor/iron,
/area/ruin/space/has_grav/listeningstation)
"fg" = (
/obj/effect/decal/cleanable/dirt,
/obj/machinery/atmospherics/components/unary/vent_scrubber/on/layer1{
	dir = 4
	},
/turf/open/floor/iron/dark,
/area/ruin/space/has_grav/listeningstation)
"hc" = (
/obj/structure/railing,
/obj/structure/cable,
/obj/effect/decal/cleanable/dirt,
/obj/machinery/atmospherics/pipe/simple/scrubbers/hidden/layer1{
	dir = 4
	},
/obj/machinery/atmospherics/pipe/simple/supply/hidden/layer3{
	dir = 4
	},
/turf/open/floor/iron,
/area/ruin/space/has_grav/listeningstation)
"hp" = (
/obj/machinery/door/airlock/external,
/obj/effect/mapping_helpers/airlock/cyclelink_helper{
	dir = 8
	},
/obj/effect/mapping_helpers/airlock/access/all/syndicate/general,
/obj/effect/decal/cleanable/dirt,
/turf/open/floor/plating,
/area/ruin/space/has_grav/listeningstation)
"hy" = (
/obj/structure/railing,
/turf/open/floor/iron,
/area/ruin/space/has_grav/listeningstation)
"hC" = (
/obj/effect/decal/cleanable/dirt,
/obj/machinery/atmospherics/pipe/simple/scrubbers/hidden/layer1,
/obj/machinery/atmospherics/pipe/simple/supply/hidden/layer3,
/turf/open/floor/iron,
/area/ruin/space/has_grav/listeningstation)
"hY" = (
/obj/structure/cable,
/obj/effect/decal/cleanable/dirt,
/obj/machinery/button/door{
	id = "commsagent_hangar_warehouse";
	name = "Hangar Warehouse";
	req_access = list(150);
	pixel_y = -24
	},
/obj/effect/turf_decal/stripes/corner,
/turf/open/floor/iron,
/area/ruin/space/has_grav/listeningstation)
"iv" = (
/obj/machinery/atmospherics/components/binary/valve/on/layer3,
/turf/open/floor/engine/hull{
	initial_gas_mix = "o2=22;n2=82;TEMP=293.15";
	name = "interior hull plating"
	},
/area/ruin/space/has_grav/listeningstation)
"iy" = (
/turf/open/floor/iron/dark,
/area/ruin/space/has_grav/listeningstation)
"jg" = (
/obj/machinery/atmospherics/pipe/simple/scrubbers/hidden/layer1,
/obj/effect/decal/cleanable/dirt,
/turf/open/floor/iron,
/area/ruin/space/has_grav/listeningstation)
"ji" = (
/obj/machinery/door/airlock/external,
/obj/effect/mapping_helpers/airlock/cyclelink_helper{
	dir = 4
	},
/obj/effect/mapping_helpers/airlock/access/all/syndicate/general,
/obj/effect/decal/cleanable/dirt,
/turf/open/floor/plating,
/area/ruin/space/has_grav/listeningstation)
"jI" = (
/obj/structure/cable,
/obj/effect/decal/cleanable/dirt,
/obj/machinery/atmospherics/pipe/simple/scrubbers/hidden/layer1,
/obj/effect/turf_decal/stripes/line,
/turf/open/floor/iron,
/area/ruin/space/has_grav/listeningstation)
"kT" = (
/obj/structure/railing,
/obj/effect/decal/cleanable/dirt,
/obj/machinery/atmospherics/pipe/simple/scrubbers/hidden/layer1{
	dir = 4
	},
/obj/machinery/atmospherics/pipe/simple/supply/hidden/layer3{
	dir = 4
	},
/turf/open/floor/iron,
/area/ruin/space/has_grav/listeningstation)
"kV" = (
/obj/structure/railing/corner{
	dir = 4
	},
/obj/structure/cable,
/obj/machinery/atmospherics/pipe/simple/supply/hidden/layer3{
	dir = 5
	},
/obj/machinery/atmospherics/pipe/simple/scrubbers/hidden/layer1{
	dir = 5
	},
/turf/open/floor/iron,
/area/ruin/space/has_grav/listeningstation)
"lY" = (
/obj/structure/railing,
/obj/machinery/light{
	dir = 4
	},
/turf/open/floor/iron,
/area/ruin/space/has_grav/listeningstation)
"mi" = (
/obj/machinery/airalarm/syndicate/directional/south,
/turf/open/floor/iron/dark,
/area/ruin/space/has_grav/listeningstation)
"mC" = (
/obj/structure/railing{
	dir = 4
	},
/obj/structure/cable,
/obj/machinery/atmospherics/pipe/simple/supply/hidden/layer3,
/obj/machinery/atmospherics/pipe/simple/scrubbers/hidden/layer1,
/turf/open/floor/iron,
/area/ruin/space/has_grav/listeningstation)
"mN" = (
/obj/machinery/power/smes/engineering,
/obj/structure/cable,
/obj/effect/decal/cleanable/dirt,
/turf/open/floor/plating,
/area/ruin/space/has_grav/listeningstation)
"mV" = (
/obj/effect/decal/cleanable/dirt,
/obj/machinery/firealarm/directional/south,
/turf/open/floor/iron/dark,
/area/ruin/space/has_grav/listeningstation)
"ni" = (
/obj/effect/turf_decal/delivery,
/obj/structure/closet/crate{
	name = "food crate"
	},
/obj/item/reagent_containers/food/drinks/waterbottle/large{
	pixel_x = -5;
	pixel_y = 3
	},
/obj/item/reagent_containers/food/drinks/waterbottle/large{
	pixel_x = 2;
	pixel_y = 3
	},
/obj/item/reagent_containers/food/drinks/waterbottle/large{
	pixel_x = -2
	},
/obj/item/reagent_containers/food/drinks/waterbottle/large{
	pixel_x = 5
	},
/obj/item/reagent_containers/food/drinks/waterbottle/large{
	pixel_x = 1;
	pixel_y = -3
	},
/obj/item/reagent_containers/food/drinks/waterbottle/large{
	pixel_x = 8;
	pixel_y = -3
	},
/obj/effect/decal/cleanable/dirt,
/turf/open/floor/iron/dark,
/area/ruin/space/has_grav/listeningstation)
"nl" = (
/obj/structure/railing,
/obj/structure/cable,
/obj/effect/decal/cleanable/dirt,
/obj/machinery/atmospherics/pipe/manifold/supply/hidden/layer3,
/obj/machinery/atmospherics/pipe/manifold/scrubbers/hidden/layer1,
/turf/open/floor/iron,
/area/ruin/space/has_grav/listeningstation)
"nn" = (
/obj/effect/decal/cleanable/dirt,
/obj/machinery/firealarm/directional/west,
/turf/open/floor/plating,
/area/ruin/space/has_grav/listeningstation)
"oa" = (
/obj/effect/decal/cleanable/dirt,
/obj/machinery/light/broken{
	dir = 8
	},
/turf/open/floor/iron/dark,
/area/ruin/space/has_grav/listeningstation)
"oP" = (
/obj/machinery/power/terminal{
	dir = 4
	},
/obj/structure/cable,
/obj/effect/decal/cleanable/dirt,
/turf/open/floor/plating,
/area/ruin/space/has_grav/listeningstation)
"pq" = (
/turf/open/floor/iron,
/area/ruin/space/has_grav/listeningstation)
"qb" = (
/obj/structure/railing{
	dir = 1
	},
/obj/effect/decal/cleanable/dirt,
/obj/machinery/atmospherics/pipe/manifold/supply/hidden/layer3{
	dir = 1
	},
/obj/machinery/atmospherics/pipe/simple/scrubbers/hidden/layer1{
	dir = 4
	},
/turf/open/floor/iron,
/area/ruin/space/has_grav/listeningstation)
"qf" = (
/obj/structure/railing{
	dir = 1
	},
/obj/machinery/atmospherics/pipe/simple/scrubbers/hidden/layer1{
	dir = 4
	},
/obj/effect/decal/cleanable/dirt,
/turf/open/floor/iron,
/area/ruin/space/has_grav/listeningstation)
"qG" = (
/obj/machinery/atmospherics/components/unary/outlet_injector/on/layer1{
	dir = 8
	},
/turf/open/floor/plating/airless,
/area/ruin/space/has_grav/listeningstation)
"qW" = (
/obj/structure/closet/crate/engineering/electrical,
/obj/item/storage/toolbox/electrical,
/obj/item/stock_parts/cell/hyper,
/obj/item/stock_parts/cell/high,
/obj/effect/turf_decal/delivery,
/turf/open/floor/iron/dark,
/area/ruin/space/has_grav/listeningstation)
"qY" = (
/obj/effect/decal/cleanable/dirt,
/turf/open/floor/plating,
/area/ruin/space/has_grav/listeningstation)
"rb" = (
/obj/effect/decal/cleanable/dirt,
/obj/machinery/atmospherics/pipe/simple/scrubbers/hidden/layer1,
/turf/open/floor/iron/dark,
/area/ruin/space/has_grav/listeningstation)
"rg" = (
/obj/machinery/atmospherics/components/unary/vent_scrubber/on/layer1,
/turf/open/floor/mineral/plastitanium/red,
/area/ruin/space/has_grav/listeningstation)
"rj" = (
/obj/structure/cable,
/turf/closed/wall/r_wall,
/area/ruin/space/has_grav/listeningstation)
"rW" = (
/obj/machinery/door/poddoor/shutters{
	id = "commsagent_hangar_warehouse"
	},
/obj/machinery/door/firedoor,
/obj/machinery/atmospherics/pipe/simple/supply/hidden/layer3,
/turf/open/floor/iron/dark,
/area/ruin/space/has_grav/listeningstation)
"sE" = (
/obj/effect/decal/cleanable/dirt,
/obj/machinery/atmospherics/components/unary/vent_scrubber/on/layer1{
	dir = 4
	},
/turf/open/floor/iron,
/area/ruin/space/has_grav/listeningstation)
"sW" = (
/obj/effect/turf_decal/delivery,
/obj/item/reagent_containers/food/snacks/canned/beans{
	pixel_x = -5;
	pixel_y = 3
	},
/obj/item/reagent_containers/food/snacks/canned/beans{
	pixel_x = 2;
	pixel_y = 3
	},
/obj/item/reagent_containers/food/snacks/canned/beans{
	pixel_x = -2
	},
/obj/item/reagent_containers/food/snacks/canned/beans{
	pixel_x = 5
	},
/obj/item/reagent_containers/food/snacks/canned/beans{
	pixel_x = 1;
	pixel_y = -3
	},
/obj/item/reagent_containers/food/snacks/canned/beans{
	pixel_x = 8;
	pixel_y = -3
	},
/obj/structure/closet/crate{
	name = "food crate"
	},
/obj/effect/decal/cleanable/dirt,
/obj/machinery/atmospherics/pipe/simple/scrubbers/hidden/layer1{
	dir = 4
	},
/obj/item/pizzabox/margherita,
/turf/open/floor/iron/dark,
/area/ruin/space/has_grav/listeningstation)
"tj" = (
/obj/effect/decal/cleanable/dirt,
/obj/machinery/atmospherics/pipe/simple/supply/hidden/layer3,
/obj/effect/turf_decal/stripes/line{
	dir = 1
	},
/turf/open/floor/iron/dark,
/area/ruin/space/has_grav/listeningstation)
"vq" = (
/obj/effect/decal/cleanable/dirt,
/turf/open/floor/mineral/plastitanium/red,
/area/ruin/space/has_grav/listeningstation)
"vH" = (
/obj/effect/decal/cleanable/dirt,
/obj/machinery/atmospherics/pipe/simple/supply/hidden/layer3{
	dir = 5
	},
/turf/open/floor/iron/dark,
/area/ruin/space/has_grav/listeningstation)
"wB" = (
/obj/machinery/door/poddoor/shutters{
	id = "commsagent_hangar_warehouse"
	},
/obj/machinery/door/firedoor,
/turf/open/floor/iron/dark,
/area/ruin/space/has_grav/listeningstation)
"wD" = (
/obj/structure/cable,
/obj/effect/decal/cleanable/dirt,
/turf/open/floor/iron,
/area/ruin/space/has_grav/listeningstation)
"xi" = (
/obj/effect/decal/cleanable/dirt,
/obj/machinery/firealarm/directional/north,
/turf/open/floor/iron,
/area/ruin/space/has_grav/listeningstation)
"zC" = (
/obj/effect/decal/cleanable/dirt,
/obj/machinery/atmospherics/pipe/simple/supply/hidden/layer3,
/turf/open/floor/iron/dark,
/area/ruin/space/has_grav/listeningstation)
"zK" = (
/obj/structure/railing/corner{
	dir = 4
	},
/obj/structure/railing/corner{
	dir = 1
	},
/obj/machinery/atmospherics/pipe/simple/supply/hidden/layer3{
	dir = 4
	},
/obj/effect/decal/cleanable/dirt,
/obj/machinery/atmospherics/pipe/simple/scrubbers/hidden/layer1{
	dir = 4
	},
/turf/open/floor/iron,
/area/ruin/space/has_grav/listeningstation)
"An" = (
/obj/structure/cable,
/obj/machinery/atmospherics/pipe/simple/supply/hidden/layer3,
/obj/effect/decal/cleanable/dirt,
/obj/machinery/atmospherics/pipe/simple/scrubbers/hidden/layer1,
/turf/open/floor/iron,
/area/ruin/space/has_grav/listeningstation)
"Aq" = (
/obj/machinery/power/rtg/advanced,
/obj/structure/cable,
/obj/effect/decal/cleanable/dirt,
/turf/open/floor/plating,
/area/ruin/space/has_grav/listeningstation)
"Cn" = (
/obj/structure/rack,
/obj/item/clothing/mask/gas/syndicate,
/obj/item/tank/internals/oxygen,
/obj/effect/decal/cleanable/dirt,
/turf/open/floor/plating,
/area/ruin/space/has_grav/listeningstation)
"CU" = (
/obj/structure/railing,
/obj/machinery/atmospherics/pipe/simple/supply/hidden/layer3{
	dir = 4
	},
/obj/effect/decal/cleanable/dirt,
/obj/machinery/atmospherics/pipe/simple/scrubbers/hidden/layer1{
	dir = 4
	},
/turf/open/floor/iron,
/area/ruin/space/has_grav/listeningstation)
"DN" = (
/obj/effect/decal/cleanable/dirt,
/obj/machinery/atmospherics/pipe/manifold/supply/hidden/layer3{
	dir = 8
	},
/obj/machinery/atmospherics/components/unary/vent_scrubber/on/layer1,
/turf/open/floor/plating,
/area/ruin/space/has_grav/listeningstation)
"En" = (
/obj/effect/decal/cleanable/dirt,
/obj/effect/turf_decal/stripes/line{
	dir = 1
	},
/turf/open/floor/iron/dark,
/area/ruin/space/has_grav/listeningstation)
"Fk" = (
/obj/structure/railing,
/obj/effect/decal/cleanable/dirt,
/obj/machinery/atmospherics/pipe/simple/scrubbers/hidden/layer1{
	dir = 9
	},
/obj/machinery/atmospherics/pipe/simple/supply/hidden/layer3{
	dir = 9
	},
/turf/open/floor/iron,
/area/ruin/space/has_grav/listeningstation)
"Fm" = (
/obj/structure/cable,
/obj/effect/decal/cleanable/dirt,
/obj/effect/turf_decal/stripes/line,
/turf/open/floor/iron,
/area/ruin/space/has_grav/listeningstation)
"FD" = (
/obj/effect/decal/cleanable/dirt,
/obj/machinery/light/broken{
	dir = 8
	},
/turf/open/floor/plating,
/area/ruin/space/has_grav/listeningstation)
"FQ" = (
/obj/machinery/atmospherics/pipe/simple/supply/hidden/layer3,
/turf/open/floor/engine/hull{
	initial_gas_mix = "o2=22;n2=82;TEMP=293.15";
	name = "interior hull plating"
	},
/area/ruin/space/has_grav/listeningstation)
"Hn" = (
/obj/structure/cable,
/obj/machinery/atmospherics/pipe/layer_manifold{
	dir = 4
	},
/obj/effect/decal/cleanable/dirt,
/turf/open/floor/plating,
/area/ruin/space/has_grav/listeningstation)
"Ib" = (
/obj/structure/cable,
/obj/machinery/power/apc/auto_name/north,
/obj/effect/decal/cleanable/dirt,
/turf/open/floor/iron,
/area/ruin/space/has_grav/listeningstation)
"Ie" = (
/obj/effect/decal/cleanable/dirt,
/turf/open/floor/iron/dark,
/area/ruin/space/has_grav/listeningstation)
"IO" = (
/obj/structure/cable,
/obj/effect/decal/cleanable/dirt,
/obj/machinery/atmospherics/pipe/simple/supply/hidden/layer3,
/obj/effect/turf_decal/stripes/line,
/turf/open/floor/iron,
/area/ruin/space/has_grav/listeningstation)
"IP" = (
/obj/structure/railing/corner{
	dir = 8
	},
/obj/structure/railing/corner,
/obj/structure/cable,
/obj/effect/decal/cleanable/dirt,
/obj/machinery/atmospherics/pipe/simple/scrubbers/hidden/layer1{
	dir = 4
	},
/obj/machinery/atmospherics/pipe/simple/supply/hidden/layer3{
	dir = 4
	},
/turf/open/floor/iron,
/area/ruin/space/has_grav/listeningstation)
"IY" = (
/obj/effect/decal/cleanable/dirt,
/obj/effect/turf_decal/stripes/corner{
	dir = 1
	},
/turf/open/floor/iron/dark,
/area/ruin/space/has_grav/listeningstation)
"Jm" = (
/obj/effect/decal/cleanable/dirt,
/obj/machinery/airalarm/syndicate/directional/north,
/turf/open/floor/iron,
/area/ruin/space/has_grav/listeningstation)
"Kl" = (
/obj/effect/turf_decal/delivery,
/obj/item/reagent_containers/food/snacks/canned/beans{
	pixel_x = -5;
	pixel_y = 3
	},
/obj/item/reagent_containers/food/snacks/canned/beans{
	pixel_x = 2;
	pixel_y = 3
	},
/obj/item/reagent_containers/food/snacks/canned/beans{
	pixel_x = -2
	},
/obj/item/reagent_containers/food/snacks/canned/beans{
	pixel_x = 5
	},
/obj/item/reagent_containers/food/snacks/canned/beans{
	pixel_x = 1;
	pixel_y = -3
	},
/obj/item/reagent_containers/food/snacks/canned/beans{
	pixel_x = 8;
	pixel_y = -3
	},
/obj/structure/closet/crate{
	name = "food crate"
	},
/obj/effect/decal/cleanable/dirt,
/obj/item/pizzabox/margherita,
/turf/open/floor/iron/dark,
/area/ruin/space/has_grav/listeningstation)
"KG" = (
/obj/item/flashlight/flare,
/obj/item/flashlight/flare,
/obj/item/flashlight/flare,
/obj/item/flashlight/flare,
/obj/item/flashlight/flare,
/obj/item/flashlight,
/obj/item/flashlight,
/obj/item/shovel,
/obj/item/pickaxe/drill,
/obj/item/pickaxe/drill,
/obj/effect/turf_decal/delivery,
/obj/effect/decal/cleanable/dirt,
/obj/machinery/atmospherics/pipe/simple/supply/hidden/layer3{
	dir = 4
	},
/obj/structure/closet/crate,
/turf/open/floor/iron/dark,
/area/ruin/space/has_grav/listeningstation)
"KI" = (
/turf/closed/wall/r_wall,
/area/ruin/space/has_grav/listeningstation)
"KP" = (
/obj/effect/decal/cleanable/dirt,
/obj/effect/turf_decal/delivery,
/obj/effect/spawner/lootdrop/whiteship_cere_ripley,
/turf/open/floor/iron/dark,
/area/ruin/space/has_grav/listeningstation)
"Lx" = (
/obj/machinery/door/airlock/hatch,
/obj/effect/mapping_helpers/airlock/access/all/syndicate/general,
/obj/machinery/door/firedoor,
/obj/machinery/atmospherics/pipe/simple/scrubbers/hidden/layer1,
/obj/machinery/atmospherics/pipe/simple/supply/hidden/layer3,
/obj/effect/decal/cleanable/dirt,
/turf/open/floor/mineral/plastitanium/red,
/area/ruin/space/has_grav/listeningstation)
"LK" = (
/obj/effect/decal/cleanable/dirt,
/turf/open/floor/iron,
/area/ruin/space/has_grav/listeningstation)
"Mc" = (
/obj/structure/railing{
	dir = 1
	},
/obj/effect/decal/cleanable/dirt,
/obj/machinery/light{
	dir = 4
	},
/turf/open/floor/iron,
/area/ruin/space/has_grav/listeningstation)
"Mi" = (
/obj/structure/fans/tiny,
/obj/machinery/door/poddoor{
	id = "commsagent_hangar_door"
	},
/turf/open/floor/plating,
/area/ruin/space/has_grav/listeningstation)
"Mn" = (
/obj/machinery/door/airlock/maintenance_hatch,
/obj/effect/mapping_helpers/airlock/access/all/syndicate/general,
/obj/structure/cable,
/obj/machinery/atmospherics/pipe/simple/supply/hidden/layer3,
/obj/machinery/door/firedoor,
/obj/machinery/atmospherics/pipe/simple/scrubbers/hidden/layer1,
/turf/open/floor/plating,
/area/ruin/space/has_grav/listeningstation)
"Mp" = (
/obj/structure/railing/corner,
/obj/structure/cable,
/obj/machinery/atmospherics/pipe/simple/supply/hidden/layer3{
	dir = 6
	},
/obj/machinery/atmospherics/pipe/simple/scrubbers/hidden/layer1{
	dir = 6
	},
/turf/open/floor/iron,
/area/ruin/space/has_grav/listeningstation)
"MS" = (
/obj/structure/railing{
	dir = 1
	},
/obj/machinery/atmospherics/pipe/simple/supply/hidden/layer3{
	dir = 9
	},
/obj/machinery/atmospherics/pipe/simple/scrubbers/hidden/layer1{
	dir = 4
	},
/obj/effect/decal/cleanable/dirt,
/turf/open/floor/iron,
/area/ruin/space/has_grav/listeningstation)
"Nb" = (
/obj/machinery/atmospherics/pipe/simple/supply/hidden/layer3{
	dir = 4
	},
/obj/effect/decal/cleanable/dirt,
/turf/open/floor/plating,
/area/ruin/space/has_grav/listeningstation)
"Ne" = (
/obj/effect/decal/cleanable/dirt,
/obj/effect/turf_decal/delivery,
/obj/machinery/mech_bay_recharge_port{
	dir = 1
	},
/turf/open/floor/iron/dark,
/area/ruin/space/has_grav/listeningstation)
"Nx" = (
/obj/effect/decal/cleanable/dirt,
/obj/machinery/button/door{
	id = "commsagent_hangar_warehouse";
	name = "Hangar Warehouse";
	req_access = list(150);
	pixel_y = 24
	},
/obj/effect/turf_decal/stripes/corner{
	dir = 4
	},
/turf/open/floor/iron/dark,
/area/ruin/space/has_grav/listeningstation)
"Os" = (
/obj/structure/railing{
	dir = 4
	},
/obj/structure/cable,
/obj/machinery/atmospherics/pipe/simple/supply/hidden/layer3,
/obj/effect/decal/cleanable/dirt,
/obj/machinery/atmospherics/pipe/simple/scrubbers/hidden/layer1,
/turf/open/floor/iron,
/area/ruin/space/has_grav/listeningstation)
"OD" = (
/obj/structure/railing{
	dir = 4
	},
/obj/structure/cable,
/obj/machinery/atmospherics/pipe/simple/supply/hidden/layer3,
/obj/machinery/atmospherics/pipe/manifold/scrubbers/hidden/layer1{
	dir = 4
	},
/turf/open/floor/iron,
/area/ruin/space/has_grav/listeningstation)
"OR" = (
/obj/effect/decal/cleanable/dirt,
/obj/machinery/atmospherics/pipe/simple/scrubbers/hidden/layer1{
	dir = 9
	},
/turf/open/floor/iron/dark,
/area/ruin/space/has_grav/listeningstation)
"Pz" = (
/obj/machinery/firealarm/directional/north,
/obj/effect/decal/cleanable/dirt,
/turf/open/floor/mineral/plastitanium/red,
/area/ruin/space/has_grav/listeningstation)
"PC" = (
/obj/machinery/atmospherics/pipe/simple/scrubbers/hidden/layer1,
/obj/machinery/atmospherics/components/unary/vent_pump/on/layer3,
/obj/effect/decal/cleanable/dirt,
/turf/open/floor/mineral/plastitanium/red,
/area/ruin/space/has_grav/listeningstation)
"Qz" = (
/obj/effect/decal/cleanable/dirt,
/obj/machinery/atmospherics/components/unary/vent_pump/on/layer3{
	dir = 8
	},
/turf/open/floor/iron/dark,
/area/ruin/space/has_grav/listeningstation)
"QE" = (
/obj/structure/cable,
/turf/open/floor/iron,
/area/ruin/space/has_grav/listeningstation)
"RA" = (
/obj/structure/table/reinforced,
/obj/effect/decal/cleanable/dirt,
/turf/open/floor/mineral/plastitanium/red,
/area/ruin/space/has_grav/listeningstation)
"SF" = (
/obj/structure/closet/crate/radiation,
/obj/item/clothing/head/radiation,
/obj/item/clothing/suit/radiation,
/obj/item/geiger_counter,
/obj/effect/turf_decal/delivery,
/turf/open/floor/iron/dark,
/area/ruin/space/has_grav/listeningstation)
"SW" = (
/turf/open/floor/mineral/plastitanium/red,
/area/ruin/space/has_grav/listeningstation)
"To" = (
/obj/structure/railing{
	dir = 4
	},
/obj/structure/cable,
/obj/machinery/atmospherics/pipe/manifold/supply/hidden/layer3{
	dir = 4
	},
/obj/machinery/atmospherics/pipe/simple/scrubbers/hidden/layer1,
/turf/open/floor/iron,
/area/ruin/space/has_grav/listeningstation)
"TR" = (
/obj/effect/decal/cleanable/dirt,
/obj/machinery/atmospherics/components/unary/vent_pump/on/layer3,
/turf/open/floor/plating,
/area/ruin/space/has_grav/listeningstation)
"Uz" = (
/obj/effect/decal/cleanable/dirt,
/turf/open/floor/engine/hull{
	initial_gas_mix = "o2=22;n2=82;TEMP=293.15";
	name = "interior hull plating"
	},
/area/ruin/space/has_grav/listeningstation)
"UB" = (
/obj/effect/decal/cleanable/dirt,
/obj/machinery/atmospherics/pipe/simple/scrubbers/hidden/layer1,
/obj/effect/turf_decal/stripes/line{
	dir = 1
	},
/turf/open/floor/iron/dark,
/area/ruin/space/has_grav/listeningstation)
"Vg" = (
/obj/structure/railing{
	dir = 1
	},
/obj/machinery/atmospherics/pipe/simple/supply/hidden/layer3{
	dir = 4
	},
/obj/effect/decal/cleanable/dirt,
/obj/machinery/atmospherics/pipe/manifold/scrubbers/hidden/layer1{
	dir = 1
	},
/turf/open/floor/iron,
/area/ruin/space/has_grav/listeningstation)
"VY" = (
/obj/structure/railing{
	dir = 1
	},
/obj/machinery/atmospherics/pipe/simple/supply/hidden/layer3{
	dir = 4
	},
/obj/effect/decal/cleanable/dirt,
/obj/machinery/atmospherics/pipe/simple/scrubbers/hidden/layer1{
	dir = 4
	},
/turf/open/floor/iron,
/area/ruin/space/has_grav/listeningstation)
"XF" = (
/obj/machinery/atmospherics/pipe/simple/scrubbers/hidden/layer1,
/obj/machinery/atmospherics/pipe/simple/supply/hidden/layer3,
/obj/effect/decal/cleanable/dirt,
/turf/open/floor/mineral/plastitanium/red,
/area/ruin/space/has_grav/listeningstation)
"XM" = (
/obj/structure/railing{
	dir = 1
	},
/obj/machinery/atmospherics/pipe/simple/scrubbers/hidden/layer1{
	dir = 10
	},
/obj/effect/decal/cleanable/dirt,
/turf/open/floor/iron,
/area/ruin/space/has_grav/listeningstation)
"XU" = (
/obj/machinery/power/rtg/advanced,
/obj/structure/cable,
/obj/effect/decal/cleanable/dirt,
/obj/machinery/airalarm/syndicate/directional/north,
/turf/open/floor/plating,
/area/ruin/space/has_grav/listeningstation)
"YR" = (
/obj/machinery/atmospherics/components/unary/tank/air{
	dir = 8
	},
/obj/effect/decal/cleanable/dirt,
/turf/open/floor/plating,
/area/ruin/space/has_grav/listeningstation)
"Zq" = (
/obj/structure/railing{
	dir = 1
	},
/obj/machinery/atmospherics/pipe/simple/supply/hidden/layer3{
	dir = 4
	},
/obj/machinery/atmospherics/pipe/simple/scrubbers/hidden/layer1{
	dir = 4
	},
/turf/open/floor/iron,
/area/ruin/space/has_grav/listeningstation)
"Zu" = (
/obj/machinery/atmospherics/pipe/simple/scrubbers/hidden/layer1,
/turf/closed/wall/r_wall,
/area/ruin/space/has_grav/listeningstation)

(1,1,1) = {"
aa
aa
aa
aa
aa
aa
aa
aa
aa
aa
aa
aa
aa
aa
aa
aa
ab
ab
ab
ab
ab
aa
aa
aa
aa
aa
aa
aa
aa
aa
aa
aa
aa
aa
aa
aa
aa
aa
"}
(2,1,1) = {"
aa
aa
aa
aa
aa
aa
ab
ab
ab
ab
ab
aa
aa
aa
ab
ab
ab
ab
ab
ab
ab
ab
ab
ab
ab
aa
aa
aa
aa
aa
aa
aa
aa
aa
aa
aa
aa
aa
"}
(3,1,1) = {"
aa
aa
aa
aa
aa
ab
ab
ab
ab
ab
ab
ab
aa
ab
ab
ab
ab
ab
ab
ab
ab
ab
ab
ab
ab
ab
ab
ab
ab
ab
aa
ab
ab
ab
aa
aa
aa
aa
"}
(4,1,1) = {"
aa
aa
aa
aa
ab
ab
ab
ab
ab
ab
ab
ab
ab
ab
ab
ab
ab
ab
ab
ab
ab
ab
ab
ab
ab
ab
ab
ab
ab
ab
ab
ab
ab
ab
ab
aa
aa
aa
"}
(5,1,1) = {"
aa
aa
aa
ab
ab
ab
ab
ab
ab
ab
ab
ab
ab
ab
ab
ab
ab
ab
ab
ab
ab
ab
ab
ab
ab
ab
ab
ab
ab
ab
ab
ab
ab
ab
ab
aa
aa
aa
"}
(6,1,1) = {"
aa
aa
aa
ab
ab
ab
ab
ab
KI
KI
KI
KI
KI
KI
KI
KI
KI
KI
KI
KI
KI
KI
KI
KI
KI
KI
KI
ab
ab
ab
ab
ab
ab
ab
ab
ab
ab
aa
"}
(7,1,1) = {"
aa
aa
ab
ab
ab
ab
ab
ab
KI
LK
pq
pq
pq
pq
pq
pq
LK
LK
LK
LK
sE
LK
sE
LK
pq
pq
KI
ab
ab
ab
ab
ab
ab
ab
ab
ab
ab
aa
"}
(8,1,1) = {"
aa
aa
ab
ab
KI
KI
KI
KI
KI
wD
Mp
mC
To
mC
To
mC
mC
mC
mC
mC
OD
mC
OD
Os
kV
QE
KI
ab
ab
ab
ab
ab
ab
ab
ab
ab
ab
aa
"}
(9,1,1) = {"
aa
aa
ab
ab
KI
Aq
FD
nn
KI
Ib
CU
aA
aA
aA
aA
aA
aA
aA
aA
aA
aA
aA
aA
Uz
VY
QE
KI
ab
ab
ab
ab
ab
ab
ab
ab
ab
ab
aa
"}
(10,1,1) = {"
aa
aa
aa
ab
KI
XU
TR
DN
Mn
An
nl
aA
aA
aA
aA
aA
aA
aA
aA
aA
aA
aA
aA
aA
VY
QE
KI
KI
KI
KI
KI
KI
KI
ab
ab
ab
ab
aa
"}
(11,1,1) = {"
aa
aa
aa
ab
KI
Aq
oP
Nb
rj
LK
hc
aA
aA
aA
aA
aA
aA
aA
aA
aA
aA
aA
aA
aA
VY
wD
KI
Ie
Ie
oa
iy
iy
KI
ab
ab
ab
aa
aa
"}
(12,1,1) = {"
aa
aa
aa
ab
KI
KI
mN
Hn
rj
LK
hc
aA
aA
aA
aA
aA
aA
aA
aA
aA
aA
aA
aA
aA
Zq
hY
KI
Nx
ni
ni
ni
iy
KI
ab
ab
ab
aa
aa
"}
(13,1,1) = {"
aa
aa
aa
ab
ab
KI
KI
YR
KI
LK
hc
aA
aA
aA
aA
aA
aA
aA
aA
aA
aA
aA
aA
aA
VY
Fm
wB
En
Ie
fg
Ie
Ie
KI
ab
ab
ab
ab
aa
"}
(14,1,1) = {"
aa
aa
aa
ab
ab
ab
KI
KI
KI
LK
hc
aA
aA
aA
aA
aA
aA
aA
aA
aA
aA
aA
aA
aA
VY
Fm
wB
En
Kl
sW
Kl
Ie
KI
ab
ab
ab
ab
aa
"}
(15,1,1) = {"
aa
aa
aa
ab
ab
ab
ab
ab
KI
pq
hc
aA
aA
aA
aA
aA
aA
aA
aA
aA
aA
aA
aA
aA
Vg
jI
al
UB
rb
OR
Ie
mV
KI
ab
ab
ab
ab
aa
"}
(16,1,1) = {"
aa
aa
aa
ab
ab
ab
ab
ab
KI
LK
hc
aA
aA
aA
aA
aA
aA
aA
aA
aA
aA
aA
aA
aA
qb
IO
rW
tj
zC
vH
Ie
mi
KI
ab
ab
ab
ab
aa
"}
(17,1,1) = {"
aa
aa
ab
ab
ab
ab
ab
ab
KI
LK
IP
bD
aA
aA
aA
aA
aA
aA
aA
aA
aA
aA
aA
aA
zK
Fm
wB
En
qW
KG
SF
Ie
KI
ab
ab
ab
ab
aa
"}
(18,1,1) = {"
aa
ab
ab
ab
ab
ab
ab
ab
KI
pq
hc
aA
aA
aA
aA
aA
aA
aA
aA
aA
aA
aA
aA
aA
VY
Fm
wB
En
Ie
Qz
Ie
Ie
KI
ab
ab
ab
ab
aa
"}
(19,1,1) = {"
aa
ab
ab
ab
ab
ab
ab
ab
KI
LK
hc
aA
aA
aA
aA
aA
aA
aA
aA
aA
aA
aA
aA
aA
VY
bl
KI
IY
KP
Ne
ca
Ie
KI
ab
ab
ab
ab
aa
"}
(20,1,1) = {"
ab
ab
ab
ab
ab
ab
ab
ab
KI
dj
hc
aA
aA
aA
aA
aA
aA
aA
aA
aA
aA
aA
aA
aA
cE
dj
KI
Ie
Ie
db
Ie
Ie
KI
ab
ab
ab
ab
ab
"}
(21,1,1) = {"
ab
ab
ab
ab
ab
ab
ab
ab
KI
LK
kT
aA
aA
aA
aA
aA
aA
aA
aA
aA
aA
aA
aA
aA
cE
LK
KI
KI
KI
KI
KI
KI
KI
ab
ab
ab
ab
ab
"}
(22,1,1) = {"
ab
ab
ab
ab
ab
ab
ab
ab
KI
LK
kT
aA
aA
aA
aA
aA
aA
aA
aA
aA
aA
aA
aA
aA
cE
LK
KI
ab
ab
ab
ab
ab
ab
ab
ab
ab
ab
ab
"}
(23,1,1) = {"
aa
ab
ab
KI
KI
KI
KI
KI
KI
LK
kT
aA
aA
aA
aA
aA
aA
aA
aA
aA
aA
aA
aA
aA
cE
LK
KI
ab
ab
ab
ab
ab
ab
ab
ab
ab
ab
ab
"}
(24,1,1) = {"
aa
ab
ab
KI
RA
bx
RA
RA
KI
Jm
kT
aA
aA
aA
aA
aA
aA
aA
aA
aA
aA
iv
FQ
FQ
MS
LK
KI
ab
ab
ab
ab
ab
ab
ab
ab
ab
ab
ab
"}
(25,1,1) = {"
aa
ab
ab
KI
Pz
rg
PC
XF
Lx
hC
Fk
aA
aA
aA
aA
aA
aA
aA
aA
aA
aA
aA
aA
aA
qf
LK
KI
ab
ab
ab
ab
ab
ab
ab
ab
ab
ab
aa
"}
(26,1,1) = {"
aa
ab
ab
KI
vq
cm
SW
SW
KI
xi
hy
aA
aA
aA
aA
aA
aA
aA
aA
aA
aA
aA
aA
aA
qf
LK
KI
ab
ab
ab
ab
ab
ab
aa
aa
aa
aa
aa
"}
(27,1,1) = {"
aa
aa
ab
KI
KI
KI
ji
KI
KI
LK
hy
aA
aA
aA
aA
aA
aA
aA
aA
aA
aA
aA
aA
aA
qf
LK
KI
ab
ab
ab
ab
ab
aa
aa
aa
aa
aa
aa
"}
(28,1,1) = {"
aa
aa
aa
aa
ab
KI
qY
Cn
KI
pq
hy
aA
aA
aA
aA
aA
aA
aA
aA
aA
aA
aA
aA
aA
qf
LK
KI
ab
ab
ab
ab
aa
aa
aa
aa
aa
aa
aa
"}
(29,1,1) = {"
aa
aa
aa
aa
aa
KI
qY
bU
KI
pq
hy
aA
aA
aA
aA
aA
aA
aA
aA
aA
aA
aA
aA
aA
XM
jg
Zu
bk
ab
aa
aa
aa
aa
aa
aa
aa
aa
aa
"}
(30,1,1) = {"
aa
aa
aa
aa
aa
KI
hp
KI
KI
pq
lY
aA
aA
aA
aA
aA
aA
aA
aA
aA
aA
aA
aA
aA
Mc
LK
KI
qG
aa
aa
aa
aa
aa
aa
aa
aa
aa
aa
"}
(31,1,1) = {"
aa
aa
aa
aa
aa
aa
aa
ab
KI
KI
KI
Mi
Mi
Mi
Mi
Mi
Mi
Mi
Mi
Mi
Mi
Mi
Mi
Mi
KI
KI
KI
aa
aa
aa
aa
aa
aa
aa
aa
aa
aa
aa
"}
(32,1,1) = {"
aa
aa
aa
aa
aa
aa
aa
aa
aa
aa
aa
aa
aa
aa
aa
aa
aa
aa
aa
aa
aa
aa
aa
aa
aa
aa
aa
aa
aa
aa
aa
aa
aa
aa
aa
aa
aa
aa
"}
