//MAP CONVERTED BY dmm2tgm.py THIS HEADER COMMENT PREVENTS RECONVERSION, DO NOT REMOVE
"aW" = (
/obj/structure/table,
/obj/machinery/recharger,
/turf/open/floor/mineral/plastitanium/red/brig,
/area/shuttle/escape)
"co" = (
/obj/machinery/light/small{
	dir = 8
	},
/turf/open/floor/carpet/purple,
/area/shuttle/escape)
"cp" = (
/turf/closed/wall/mineral/plastitanium,
/area/shuttle/escape)
"cX" = (
/obj/structure/reagent_dispensers/water_cooler,
/turf/open/floor/pod,
/area/shuttle/escape)
"de" = (
/obj/machinery/vending/cola/random,
/turf/open/floor/pod,
/area/shuttle/escape)
"eL" = (
/obj/effect/turf_decal/tile/neutral{
	dir = 8
	},
/obj/structure/chair/comfy/shuttle{
	dir = 4
	},
/turf/open/floor/pod,
/area/shuttle/escape)
"eQ" = (
/obj/structure/chair/comfy/shuttle,
/turf/open/floor/carpet/purple,
/area/shuttle/escape)
"eV" = (
/obj/structure/chair/comfy/shuttle{
	dir = 1
	},
/obj/effect/turf_decal/siding/wood{
	dir = 10
	},
/turf/open/floor/carpet/royalblue,
/area/shuttle/escape)
"ga" = (
/obj/effect/turf_decal/bot,
/obj/structure/closet/crate,
/obj/effect/spawner/lootdrop/maintenance/eight,
/turf/open/floor/iron/mil,
/area/shuttle/escape)
"go" = (
/obj/structure/table/optable,
/obj/machinery/defibrillator_mount/loaded{
	pixel_x = -26
	},
/turf/open/floor/iron/white,
/area/shuttle/escape)
"gS" = (
/obj/effect/turf_decal/siding/wood,
/obj/effect/turf_decal/siding/wood{
	dir = 1
	},
/turf/open/floor/pod/dark,
/area/shuttle/escape)
"hB" = (
/obj/structure/flora/ausbushes/leafybush,
/obj/structure/window/reinforced/survival_pod{
	dir = 4
	},
/obj/structure/window/reinforced/survival_pod{
	dir = 1
	},
/obj/structure/window/reinforced/survival_pod{
	dir = 5
	},
/turf/open/floor/grass,
/area/shuttle/escape)
"ii" = (
/obj/effect/turf_decal/tile/neutral{
	dir = 4
	},
/obj/structure/chair/comfy/shuttle{
	dir = 8
	},
/turf/open/floor/pod,
/area/shuttle/escape)
"iw" = (
/turf/open/floor/pod,
/area/shuttle/escape)
"jm" = (
/obj/structure/chair/comfy/shuttle{
	dir = 4
	},
/turf/open/floor/pod,
/area/shuttle/escape)
"jq" = (
/obj/structure/table,
/obj/item/storage/firstaid/regular{
	pixel_x = 2;
	pixel_y = 3
	},
/obj/item/crowbar,
/obj/item/storage/firstaid/fire,
/turf/open/floor/wood,
/area/shuttle/escape)
"jG" = (
/obj/machinery/flasher{
	id = "shuttle_flasher";
	pixel_y = 24
	},
/turf/open/floor/pod/dark,
/area/shuttle/escape)
"jH" = (
/obj/structure/fans/tiny,
/obj/effect/turf_decal/stripes/line{
	dir = 8
	},
/obj/effect/turf_decal/stripes/line{
	dir = 4
	},
/obj/machinery/door/airlock/survival_pod/glass,
/obj/structure/fans/tiny,
/obj/effect/mapping_helpers/airlock/access/any/security/general,
/turf/open/floor/plating,
/area/shuttle/escape)
"kr" = (
/obj/structure/table/wood,
/obj/item/reagent_containers/food/drinks/coffee,
/obj/item/reagent_containers/food/drinks/coffee{
	pixel_y = 10;
	pixel_x = 8
	},
/turf/open/floor/carpet/purple,
/area/shuttle/escape)
"kI" = (
/obj/structure/chair/comfy/shuttle{
	dir = 8
	},
/turf/open/floor/wood,
/area/shuttle/escape)
"kX" = (
/obj/structure/shuttle/engine/heater,
/obj/structure/window/reinforced/survival_pod{
	dir = 1
	},
/obj/effect/turf_decal/stripes/line{
	dir = 1
	},
/turf/open/floor/plating/airless,
/area/shuttle/escape)
"li" = (
/obj/machinery/status_display/evac{
	pixel_x = 32
	},
/obj/item/kirbyplants/random,
/turf/open/floor/wood,
/area/shuttle/escape)
"lz" = (
/obj/structure/flora/ausbushes/brflowers,
/obj/structure/flora/ausbushes/sunnybush,
/obj/structure/window/reinforced/survival_pod{
	dir = 1
	},
/turf/open/floor/grass,
/area/shuttle/escape)
"lI" = (
/obj/structure/chair/sofa/right{
	dir = 8
	},
/obj/machinery/light/small{
	dir = 4
	},
/turf/open/floor/pod/dark,
/area/shuttle/escape)
"nk" = (
/obj/machinery/status_display/ai{
	pixel_x = -32
	},
/turf/open/floor/wood,
/area/shuttle/escape)
"np" = (
/obj/machinery/door/airlock/security/glass,
/obj/effect/mapping_helpers/airlock/access/any/security/general,
/turf/open/floor/mineral/plastitanium/red/brig,
/area/shuttle/escape)
"pF" = (
/obj/structure/lattice,
/turf/template_noop,
/area/shuttle/escape)
"pT" = (
/turf/open/floor/pod/dark,
/area/shuttle/escape)
"qc" = (
/obj/machinery/computer/operating{
	dir = 4
	},
/obj/machinery/vending/wallmed{
	pixel_x = -32
	},
/turf/open/floor/iron/white,
/area/shuttle/escape)
"qx" = (
/obj/structure/chair/comfy/shuttle{
	dir = 8
	},
/obj/machinery/light/small{
	dir = 4
	},
/turf/open/floor/mineral/plastitanium/red/brig,
/area/shuttle/escape)
"qV" = (
/obj/structure/table,
/obj/item/reagent_containers/food/drinks/bottle/vodka{
	pixel_y = 12;
	pixel_x = 5
	},
/obj/item/reagent_containers/food/drinks/bottle/orangejuice{
	pixel_x = -8
	},
/obj/item/reagent_containers/food/drinks/bottle/vodka,
/turf/open/floor/pod,
/area/shuttle/escape)
"rm" = (
/obj/structure/window/reinforced/survival_pod,
/obj/effect/turf_decal/stripes/line,
/obj/structure/window/reinforced/survival_pod{
	dir = 1
	},
/turf/open/floor/fakespace,
/area/shuttle/escape)
"rn" = (
/obj/structure/window/shuttle/survival_pod,
/turf/open/floor/plating,
/area/shuttle/escape)
"rF" = (
/obj/machinery/vending/snack/random,
/turf/open/floor/pod,
/area/shuttle/escape)
"rU" = (
/obj/machinery/computer/emergency_shuttle,
/obj/effect/turf_decal/siding/wood,
/turf/open/floor/carpet/royalblue,
/area/shuttle/escape)
"sQ" = (
/obj/effect/turf_decal/bot,
/turf/open/floor/iron/mil,
/area/shuttle/escape)
"sU" = (
/obj/structure/chair/comfy/shuttle{
	dir = 4
	},
/turf/open/floor/wood,
/area/shuttle/escape)
"tF" = (
/turf/open/floor/mineral/plastitanium/red/brig,
/area/shuttle/escape)
"tQ" = (
/obj/structure/fans/tiny,
/obj/effect/turf_decal/stripes/line{
	dir = 4
	},
/obj/effect/turf_decal/stripes/line{
	dir = 8
	},
/obj/machinery/door/airlock/survival_pod/glass,
/obj/structure/fans/tiny,
/turf/open/floor/plating,
/area/shuttle/escape)
"tY" = (
/obj/machinery/door/airlock/research,
/turf/open/floor/pod,
/area/shuttle/escape)
"ug" = (
/obj/machinery/light/small{
	dir = 4
	},
/obj/structure/chair/comfy/shuttle{
	dir = 8
	},
/turf/open/floor/iron/white,
/area/shuttle/escape)
"uj" = (
/obj/effect/spawner/structure/window/plasma/reinforced/plastitanium,
/turf/open/floor/plating,
/area/shuttle/escape)
"uM" = (
/obj/structure/chair/comfy/shuttle{
	dir = 4
	},
/obj/item/radio/intercom{
	name = "Station Intercom (General)";
	pixel_y = -29
	},
/turf/open/floor/wood,
/area/shuttle/escape)
"uY" = (
/obj/structure/chair/comfy/shuttle{
	dir = 8
	},
/turf/open/floor/pod,
/area/shuttle/escape)
"wo" = (
/obj/structure/table,
/obj/machinery/recharger,
/turf/open/floor/wood,
/area/shuttle/escape)
"wJ" = (
/obj/machinery/door/airlock/engineering,
/turf/open/floor/pod,
/area/shuttle/escape)
"xh" = (
/obj/structure/extinguisher_cabinet{
	pixel_x = -30
	},
/turf/open/floor/iron/mil,
/area/shuttle/escape)
"xS" = (
/obj/structure/shuttle/engine/heater,
/obj/effect/turf_decal/stripes/line{
	dir = 1
	},
/obj/structure/window/reinforced/survival_pod{
	dir = 1
	},
/turf/open/floor/plating/airless,
/area/shuttle/escape)
"yX" = (
/obj/structure/chair/comfy/shuttle{
	dir = 1
	},
/obj/effect/turf_decal/siding/wood{
	dir = 6
	},
/turf/open/floor/carpet/royalblue,
/area/shuttle/escape)
"zn" = (
/obj/effect/turf_decal/tile/neutral{
	dir = 1
	},
/obj/structure/chair/comfy/shuttle{
	dir = 4
	},
/turf/open/floor/pod,
/area/shuttle/escape)
"Be" = (
/obj/structure/flora/grass/jungle/b,
/obj/structure/flora/junglebush,
/obj/structure/window/reinforced/survival_pod{
	dir = 1
	},
/turf/open/floor/grass,
/area/shuttle/escape)
"Bn" = (
/obj/structure/chair/comfy/shuttle,
/turf/open/floor/mineral/plastitanium/red/brig,
/area/shuttle/escape)
"By" = (
/obj/structure/window/reinforced/survival_pod,
/obj/effect/turf_decal/stripes/line,
/obj/structure/window/reinforced/survival_pod{
	dir = 1
	},
/obj/item/toy/plush/carpplushie,
/turf/open/floor/fakespace,
/area/shuttle/escape)
"Bz" = (
/obj/effect/turf_decal/tile/neutral,
/obj/structure/chair/comfy/shuttle{
	dir = 8
	},
/turf/open/floor/pod,
/area/shuttle/escape)
"BX" = (
/turf/open/floor/iron/mil,
/area/shuttle/escape)
"Cu" = (
/obj/machinery/light/small{
	dir = 8
	},
/obj/effect/turf_decal/siding/wood,
/obj/effect/turf_decal/siding/wood{
	dir = 1
	},
/turf/open/floor/pod/dark,
/area/shuttle/escape)
"CJ" = (
/turf/closed/wall/mineral/titanium/survival,
/area/shuttle/escape)
"Dh" = (
/obj/structure/table,
/obj/item/screwdriver,
/turf/open/floor/pod,
/area/shuttle/escape)
"DU" = (
/obj/machinery/light{
	dir = 4
	},
/turf/open/floor/pod/dark,
/area/shuttle/escape)
"Ex" = (
/obj/machinery/flasher{
	id = "cockpit_flasher";
	pixel_y = 24
	},
/turf/open/floor/pod/dark,
/area/shuttle/escape)
"EB" = (
/obj/structure/fans/tiny,
/obj/effect/turf_decal/stripes/line{
	dir = 8
	},
/obj/effect/turf_decal/stripes/line{
	dir = 4
	},
/obj/machinery/door/airlock/survival_pod/glass,
/obj/structure/fans/tiny,
/turf/open/floor/plating,
/area/shuttle/escape)
"EG" = (
/obj/structure/chair/sofa/left{
	dir = 8
	},
/obj/structure/extinguisher_cabinet{
	pixel_x = 27
	},
/turf/open/floor/pod/dark,
/area/shuttle/escape)
"Gg" = (
/obj/structure/flora/grass/jungle,
/obj/structure/window/reinforced/survival_pod{
	dir = 1
	},
/turf/open/floor/grass,
/area/shuttle/escape)
"HX" = (
/obj/machinery/door/airlock/command/glass{
	name = "Bridge"
	},
/obj/effect/mapping_helpers/airlock/access/any/command/general,
/obj/effect/mapping_helpers/airlock/cyclelink_helper,
/turf/open/floor/wood,
/area/shuttle/escape)
"Iv" = (
/obj/structure/table,
/obj/item/paper_bin{
	pixel_y = 4
	},
/obj/item/pen,
/turf/open/floor/pod,
/area/shuttle/escape)
"IC" = (
/obj/structure/chair/sofa/left{
	dir = 4
	},
/turf/open/floor/pod/dark,
/area/shuttle/escape)
"Jj" = (
/obj/effect/turf_decal/stripes/line{
	dir = 9
	},
/obj/item/reagent_containers/food/drinks/coffee{
	pixel_x = 9;
	pixel_y = -1
	},
/obj/effect/decal/cleanable/generic,
/turf/open/floor/plating/airless,
/area/shuttle/escape)
"Kn" = (
/obj/machinery/status_display/evac,
/turf/closed/wall/mineral/titanium/survival,
/area/shuttle/escape)
"Ky" = (
/obj/structure/chair/comfy/shuttle{
	dir = 8
	},
/obj/structure/extinguisher_cabinet{
	pixel_y = -30
	},
/turf/open/floor/wood,
/area/shuttle/escape)
"Lj" = (
/obj/item/kirbyplants/random,
/turf/open/floor/pod,
/area/shuttle/escape)
"Lu" = (
/obj/machinery/door/airlock/medical/glass{
	name = "Physician"
	},
/obj/effect/turf_decal/stripes/line{
	dir = 1
	},
/turf/open/floor/iron/white,
/area/shuttle/escape)
"MM" = (
/obj/machinery/computer/atmos_alert{
	dir = 4
	},
/obj/machinery/light{
	dir = 8
	},
/obj/effect/turf_decal/siding/wood{
	dir = 4
	},
/turf/open/floor/carpet/green,
/area/shuttle/escape)
"MP" = (
/obj/structure/flora/rock/jungle,
/obj/structure/flora/ausbushes/ppflowers,
/obj/structure/window/reinforced/survival_pod{
	dir = 8
	},
/obj/structure/window/reinforced/survival_pod{
	dir = 1
	},
/obj/structure/window/reinforced/survival_pod{
	dir = 9
	},
/turf/open/floor/grass,
/area/shuttle/escape)
"Nk" = (
/turf/closed/wall/mineral/titanium/survival/nodiagonal,
/area/shuttle/escape)
"NR" = (
/obj/machinery/computer/security{
	dir = 8
	},
/obj/machinery/light{
	dir = 4
	},
/obj/effect/turf_decal/siding/wood{
	dir = 8
	},
/turf/open/floor/carpet/red,
/area/shuttle/escape)
"Ox" = (
/obj/machinery/light{
	dir = 8
	},
/turf/open/floor/pod/dark,
/area/shuttle/escape)
"OH" = (
/turf/open/floor/wood,
/area/shuttle/escape)
"QC" = (
/obj/machinery/computer/security/wooden_tv,
/turf/open/floor/pod,
/area/shuttle/escape)
"QK" = (
/obj/machinery/status_display/evac{
	pixel_y = -32
	},
/turf/open/floor/pod/dark,
/area/shuttle/escape)
"QT" = (
/obj/docking_port/mobile/emergency{
	name = "Hole emergency shuttle"
	},
/obj/structure/fans/tiny,
/obj/effect/turf_decal/stripes/line{
	dir = 8
	},
/obj/effect/turf_decal/stripes/line{
	dir = 4
	},
/obj/machinery/door/airlock/survival_pod/glass,
/obj/structure/fans/tiny,
/turf/open/floor/plating,
/area/shuttle/escape)
"Rc" = (
/obj/structure/extinguisher_cabinet{
	pixel_x = 27
	},
/turf/open/floor/iron/white,
/area/shuttle/escape)
"Rj" = (
/obj/machinery/button/flasher{
	id = "cockpit_flasher";
	pixel_x = 24;
	pixel_y = -6
	},
/turf/open/floor/wood,
/area/shuttle/escape)
"RB" = (
/obj/structure/table,
/obj/item/storage/firstaid/regular{
	pixel_x = 2;
	pixel_y = 3
	},
/obj/item/storage/firstaid/fire,
/obj/item/crowbar,
/turf/open/floor/iron/white,
/area/shuttle/escape)
"Sk" = (
/obj/machinery/door/airlock/mining/glass,
/obj/effect/turf_decal/stripes/line{
	dir = 1
	},
/turf/open/floor/iron/mil,
/area/shuttle/escape)
"Tk" = (
/obj/structure/shuttle/engine/propulsion,
/turf/open/floor/plating/airless,
/area/shuttle/escape)
"TP" = (
/obj/structure/chair/sofa/right{
	dir = 4
	},
/turf/open/floor/pod/dark,
/area/shuttle/escape)
"Vw" = (
/obj/structure/lattice/catwalk,
/turf/template_noop,
/area/shuttle/escape)
"VC" = (
/obj/machinery/light/small{
	dir = 8
	},
/turf/open/floor/iron/mil,
/area/shuttle/escape)
"WB" = (
/obj/effect/turf_decal/bot,
/obj/structure/closet/crate/engineering,
/obj/item/tank/internals/emergency_oxygen/engi,
/turf/open/floor/iron/mil,
/area/shuttle/escape)
"WS" = (
/obj/structure/extinguisher_cabinet{
	pixel_x = 27
	},
/turf/open/floor/pod/dark,
/area/shuttle/escape)
"Xr" = (
/turf/closed/wall/mineral/plastitanium/nodiagonal,
/area/shuttle/escape)
"Xs" = (
/obj/machinery/computer/crew{
	dir = 4
	},
/obj/effect/turf_decal/siding/wood{
	dir = 4
	},
/turf/open/floor/carpet/green,
/area/shuttle/escape)
"Yd" = (
/obj/machinery/door/airlock/command/glass{
	name = "Bridge"
	},
/obj/effect/mapping_helpers/airlock/access/any/command/general,
/obj/effect/mapping_helpers/airlock/cyclelink_helper{
	dir = 1
	},
/turf/open/floor/wood,
/area/shuttle/escape)
"Yu" = (
/obj/structure/table,
/obj/item/storage/backpack/duffelbag/med/surgery,
/turf/open/floor/iron/white,
/area/shuttle/escape)
"ZB" = (
/obj/machinery/computer/communications{
	dir = 8
	},
/obj/effect/turf_decal/siding/wood{
	dir = 8
	},
/turf/open/floor/carpet/red,
/area/shuttle/escape)
"ZC" = (
/turf/template_noop,
/area/template_noop)
"ZQ" = (
/obj/structure/chair/comfy/shuttle{
	dir = 8
	},
/obj/machinery/button/flasher{
	id = "shuttle_flasher";
	pixel_x = 24;
	pixel_y = -6
	},
/turf/open/floor/mineral/plastitanium/red/brig,
/area/shuttle/escape)

(1,1,1) = {"
ZC
ZC
ZC
ZC
CJ
CJ
CJ
jH
CJ
QT
CJ
rn
rn
rn
CJ
EB
CJ
tQ
CJ
CJ
cp
ZC
"}
(2,1,1) = {"
ZC
ZC
ZC
Jj
CJ
Bn
tF
tF
rn
pT
Ox
pT
pT
pT
Ox
pT
Sk
BX
VC
xh
Xr
cp
"}
(3,1,1) = {"
ZC
CJ
CJ
CJ
CJ
Bn
tF
tF
np
pT
Bz
uY
uY
uY
ii
pT
rn
ga
WB
sQ
xS
Tk
"}
(4,1,1) = {"
CJ
CJ
MM
Xs
CJ
aW
qx
ZQ
rn
pT
MP
Xr
uj
Xr
Iv
QK
CJ
CJ
CJ
CJ
Xr
Tk
"}
(5,1,1) = {"
rn
wo
kI
Ky
CJ
Nk
Nk
Nk
Nk
jG
lz
uj
pF
uj
cX
pT
CJ
pT
IC
TP
rm
Tk
"}
(6,1,1) = {"
rn
eV
OH
OH
HX
nk
Cu
OH
Yd
pT
Gg
uj
Vw
uj
rF
pT
wJ
iw
qV
Dh
rm
cp
"}
(7,1,1) = {"
rn
rU
OH
OH
rn
li
gS
Rj
rn
pT
Be
uj
pF
uj
de
pT
CJ
pT
lI
EG
By
Tk
"}
(8,1,1) = {"
rn
yX
OH
OH
Kn
Nk
Nk
Nk
Nk
Ex
hB
Xr
uj
Xr
Lj
QK
CJ
CJ
CJ
CJ
Xr
Tk
"}
(9,1,1) = {"
rn
jq
sU
uM
CJ
eQ
co
iw
tY
pT
eL
jm
jm
jm
zn
pT
rn
qc
go
Yu
kX
Tk
"}
(10,1,1) = {"
CJ
CJ
NR
ZB
CJ
eQ
kr
QC
Nk
WS
DU
pT
pT
pT
DU
pT
Lu
Rc
ug
RB
Xr
cp
"}
(11,1,1) = {"
ZC
CJ
CJ
CJ
CJ
CJ
rn
CJ
CJ
CJ
CJ
rn
rn
rn
CJ
CJ
CJ
CJ
CJ
CJ
cp
ZC
"}
