//MAP CONVERTED BY dmm2tgm.py THIS HEADER COMMENT PREVENTS RECONVERSION, DO NOT REMOVE
"aa" = (
/turf/template_noop,
/area/template_noop)
"ac" = (
/turf/open/floor/plasteel/dark,
/area/template_noop)
"ae" = (
/obj/effect/spawner/structure/window/plasma/reinforced/plastitanium,
/obj/machinery/door/poddoor/shutters{
	id = "syndieshutters";
	name = "blast shutters"
	},
/turf/open/floor/plating,
/area/template_noop)
"af" = (
/obj/machinery/door/firedoor,
/obj/structure/railing{
	dir = 4
	},
/obj/structure/railing{
	dir = 8
	},
/turf/open/floor/plasteel/elevatorshaft,
/area/template_noop)
"ag" = (
/obj/structure/window/plasma/reinforced/plastitanium,
/obj/effect/turf_decal/siding/thinplating_new/dark{
	dir = 6
	},
/obj/effect/turf_decal/tile/red/whole,
/turf/open/floor/plasteel/dark/whole,
/area/template_noop)
"ah" = (
/obj/machinery/computer/secure_data/syndie,
/obj/structure/window/reinforced/survival_pod{
	dir = 4
	},
/obj/effect/turf_decal/tile/dark/whole,
/obj/effect/turf_decal/tile/red/half/contrast{
	dir = 1
	},
/turf/open/floor/mineral/plastitanium/red,
/area/template_noop)
"ai" = (
/obj/machinery/computer/camera_advanced/shuttle_docker/syndicate,
/obj/effect/turf_decal/tile/dark/whole,
/obj/effect/turf_decal/tile/red/half/contrast{
	dir = 1
	},
/turf/open/floor/mineral/plastitanium/red,
/area/template_noop)
"aj" = (
/obj/machinery/computer/arcade/orion_trail/kobayashi{
	name = "Cybersun Industries Brand Central Shuttle Console";
	desc = "Sweet, of course there's games on the shuttle!"
	},
/obj/effect/turf_decal/tile/dark/whole,
/obj/effect/turf_decal/tile/red/half/contrast{
	dir = 1
	},
/turf/open/floor/mineral/plastitanium/red,
/area/template_noop)
"ak" = (
/obj/machinery/computer/shuttle/syndicate,
/obj/effect/turf_decal/tile/dark/whole,
/obj/effect/turf_decal/tile/red/half/contrast{
	dir = 1
	},
/turf/open/floor/mineral/plastitanium/red,
/area/template_noop)
"al" = (
/obj/machinery/computer/med_data/syndie,
/obj/structure/window/reinforced/survival_pod{
	dir = 8
	},
/obj/effect/turf_decal/tile/dark/whole,
/obj/effect/turf_decal/tile/red/half/contrast{
	dir = 1
	},
/turf/open/floor/mineral/plastitanium/red,
/area/template_noop)
"am" = (
/obj/structure/window/plasma/reinforced/plastitanium,
/obj/effect/turf_decal/siding/thinplating_new/dark{
	dir = 10
	},
/obj/effect/turf_decal/tile/red/whole,
/turf/open/floor/plasteel/dark/whole,
/area/template_noop)
"an" = (
/obj/machinery/computer/camera_advanced/syndie{
	dir = 4
	},
/obj/effect/turf_decal/tile/dark/whole,
/obj/effect/turf_decal/tile/red/half/contrast{
	dir = 8
	},
/turf/open/floor/mineral/plastitanium/red,
/area/template_noop)
"ao" = (
/obj/structure/chair/comfy/shuttle{
	dir = 8;
	name = "tactical chair"
	},
/obj/structure/window/reinforced/survival_pod{
	dir = 4
	},
/obj/effect/turf_decal/tile/dark/whole,
/obj/structure/window/reinforced/survival_pod{
	dir = 6
	},
/turf/open/floor/mineral/plastitanium/red,
/area/template_noop)
"ap" = (
/obj/structure/table/reinforced,
/obj/effect/turf_decal/tile/dark/whole,
/obj/item/radio/intercom{
	freerange = 1;
	name = "Syndicate Radio Intercom"
	},
/turf/open/floor/mineral/plastitanium/red,
/area/template_noop)
"aq" = (
/obj/structure/chair/office{
	name = "tactical swivel chair";
	dir = 1
	},
/obj/effect/turf_decal/tile/dark/whole,
/turf/open/floor/mineral/plastitanium/red,
/area/template_noop)
"ar" = (
/obj/structure/chair/comfy/shuttle{
	dir = 4;
	name = "tactical chair"
	},
/obj/structure/window/reinforced/survival_pod{
	dir = 8
	},
/obj/effect/turf_decal/tile/dark/whole,
/obj/structure/window/reinforced/survival_pod{
	dir = 10
	},
/turf/open/floor/mineral/plastitanium/red,
/area/template_noop)
"as" = (
/obj/machinery/computer/crew/syndie{
	dir = 8
	},
/obj/effect/turf_decal/tile/dark/whole,
/obj/effect/turf_decal/tile/red/half/contrast{
	dir = 4
	},
/turf/open/floor/mineral/plastitanium/red,
/area/template_noop)
"at" = (
/obj/effect/turf_decal/siding/thinplating_new/dark{
	dir = 1
	},
/obj/effect/turf_decal/siding/thinplating_new/dark,
/turf/open/floor/mineral/plastitanium,
/area/template_noop)
"au" = (
/obj/effect/turf_decal/tile/red{
	dir = 8
	},
/turf/open/floor/plasteel/dark,
/area/template_noop)
"av" = (
/obj/effect/turf_decal/tile/red/half/contrast{
	dir = 1
	},
/turf/open/floor/plasteel/dark,
/area/template_noop)
"ax" = (
/obj/machinery/door/firedoor,
/obj/structure/railing{
	dir = 8
	},
/obj/structure/railing{
	dir = 4
	},
/turf/open/floor/plasteel/elevatorshaft,
/area/template_noop)
"ay" = (
/obj/machinery/sleeper/syndie{
	dir = 4
	},
/turf/open/floor/plasteel/mil/sterile/plain,
/area/template_noop)
"az" = (
/obj/machinery/door/airlock/hatch{
	name = "Cockpit";
	req_access_txt = "150"
	},
/obj/effect/mapping_helpers/airlock/cyclelink_helper,
/turf/open/floor/plasteel/dark,
/area/template_noop)
"aA" = (
/obj/structure/window/plasma/reinforced/plastitanium,
/turf/open/floor/plating,
/area/template_noop)
"aC" = (
/obj/machinery/telecomms/allinone{
	intercept = 1
	},
/obj/effect/turf_decal/tile/bar/diagonal,
/obj/effect/turf_decal/tile/dark/diagonal{
	dir = 4
	},
/obj/effect/turf_decal/siding/thinplating_new/dark{
	dir = 4
	},
/turf/open/floor/circuit/red,
/area/template_noop)
"aD" = (
/turf/open/floor/plasteel/dark/half,
/area/template_noop)
"aE" = (
/obj/machinery/recharge_station,
/obj/effect/turf_decal/tile/bar/diagonal,
/obj/effect/turf_decal/tile/dark/diagonal{
	dir = 4
	},
/obj/effect/turf_decal/siding/thinplating_new/dark{
	dir = 8
	},
/turf/open/floor/circuit/red,
/area/template_noop)
"aO" = (
/obj/structure/window/reinforced/survival_pod{
	dir = 4
	},
/obj/structure/window/reinforced/survival_pod{
	dir = 5
	},
/obj/machinery/vending/medical/syndicate_access,
/turf/open/floor/plasteel,
/area/template_noop)
"aP" = (
/turf/open/floor/plasteel/mil/sterile/plain,
/area/template_noop)
"aX" = (
/turf/open/floor/plasteel,
/area/template_noop)
"aY" = (
/obj/docking_port/mobile{
	dheight = 1;
	dir = 8;
	dwidth = 12;
	height = 17;
	hidden = 1;
	id = "syndicate";
	movement_force = list("KNOCKDOWN"=0,"THROW"=0);
	name = "syndicate infiltrator";
	port_direction = 4;
	width = 23
	},
/obj/effect/turf_decal/stripes/line{
	dir = 4
	},
/obj/effect/turf_decal/stripes/red/line{
	dir = 4
	},
/obj/machinery/door/poddoor{
	id = "smindicate";
	name = "outer blast door"
	},
/obj/machinery/button/door{
	id = "smindicate";
	name = "external door control";
	req_access_txt = "150";
	pixel_y = 28
	},
/turf/open/floor/plasteel/whole,
/area/template_noop)
"aZ" = (
/obj/effect/turf_decal/tile/red,
/turf/open/floor/plasteel/dark,
/area/template_noop)
"bg" = (
/turf/closed/wall/r_wall/syndicate/nodiagonal,
/area/template_noop)
"bi" = (
/obj/machinery/sleeper/syndie{
	dir = 8
	},
/turf/open/floor/plasteel/mil/sterile/plain,
/area/template_noop)
"ca" = (
/obj/structure/table/reinforced,
/obj/effect/turf_decal/tile/dark/whole,
/obj/machinery/button/door{
	id = "syndieshutters";
	name = "Cockpit View Control";
	req_access_txt = "150"
	},
/turf/open/floor/mineral/plastitanium/red,
/area/template_noop)
"cb" = (
/turf/open/floor/plating,
/area/template_noop)
"cj" = (
/obj/machinery/door/airlock/hatch{
	name = "Cockpit";
	req_access_txt = "150"
	},
/obj/effect/mapping_helpers/airlock/cyclelink_helper{
	dir = 1
	},
/turf/open/floor/plasteel/dark,
/area/template_noop)
"In" = (
/turf/closed/wall/r_wall/syndicate,
/area/template_noop)

(1,1,1) = {"
aa
aa
aa
aa
aa
aa
aa
aa
aa
aa
aa
aa
aa
In
In
In
In
In
In
In
In
In
In
"}
(2,1,1) = {"
aa
aa
aa
aa
aa
aa
aa
In
bg
bg
bg
bg
bg
bg
cb
cb
cb
cb
cb
cb
cb
cb
cb
"}
(3,1,1) = {"
aa
aa
aa
aa
aa
aa
aa
bg
cb
cb
cb
cb
cb
bg
cb
cb
cb
cb
cb
cb
cb
cb
cb
"}
(4,1,1) = {"
aa
aa
aa
aa
aa
aa
aa
bg
cb
cb
cb
cb
cb
bg
cb
cb
cb
cb
cb
cb
cb
cb
cb
"}
(5,1,1) = {"
In
bg
ae
ae
In
aa
aa
bg
cb
cb
cb
cb
cb
bg
cb
cb
cb
cb
cb
bg
In
In
In
"}
(6,1,1) = {"
bg
ag
an
at
bg
In
aa
bg
cb
cb
cb
cb
cb
bg
cb
cb
cb
cb
cb
In
aa
aa
aa
"}
(7,1,1) = {"
ae
ah
ao
at
ac
bg
bg
bg
ax
ax
bg
cb
bg
bg
cb
cb
cb
cb
cb
In
In
In
aa
"}
(8,1,1) = {"
ae
ai
ap
at
au
bg
aC
bg
cb
cb
cb
cb
cb
cb
cb
cb
cb
cb
cb
cb
cb
cb
aa
"}
(9,1,1) = {"
ae
aj
aq
at
av
az
aD
cj
cb
cb
cb
cb
cb
cb
cb
cb
cb
cb
cb
cb
cb
cb
aa
"}
(10,1,1) = {"
ae
ak
ca
at
aZ
bg
aE
bg
cb
cb
cb
cb
cb
cb
cb
cb
cb
cb
cb
cb
cb
cb
aa
"}
(11,1,1) = {"
ae
al
ar
at
ac
bg
bg
bg
af
af
bg
aX
bg
bg
cb
cb
cb
cb
cb
In
In
In
aa
"}
(12,1,1) = {"
bg
am
as
at
bg
In
aa
bg
aX
aX
aX
aX
aO
bg
cb
cb
cb
cb
cb
In
aa
aa
aa
"}
(13,1,1) = {"
In
bg
ae
ae
In
aa
aa
bg
aX
aX
aX
aX
ay
bg
cb
cb
cb
cb
cb
bg
In
In
In
"}
(14,1,1) = {"
aa
aa
aa
aa
aa
aa
aa
bg
aX
aX
aX
aX
aP
bg
cb
cb
cb
cb
cb
cb
cb
cb
cb
"}
(15,1,1) = {"
aa
aa
aa
aa
aa
aa
aa
bg
aX
aX
aX
aX
bi
bg
cb
cb
cb
cb
cb
cb
cb
cb
cb
"}
(16,1,1) = {"
aa
aa
aa
aa
aA
aa
aa
In
bg
bg
aY
bg
bg
bg
cb
cb
cb
cb
cb
cb
cb
cb
cb
"}
(17,1,1) = {"
aa
aa
aa
aa
aa
aa
aa
aa
aa
aa
aa
aa
aa
In
In
In
In
In
In
In
In
In
In
"}
