//MAP CONVERTED BY dmm2tgm.py THIS HEADER COMMENT PREVENTS RECONVERSION, DO NOT REMOVE
"aa" = (
/turf/template_noop,
/area/template_noop)
"ac" = (
/turf/open/floor/plasteel/dark,
/area/template_noop)
"ae" = (
/obj/effect/spawner/structure/window/plasma/reinforced/plastitanium,
/obj/machinery/door/poddoor/shutters{
	id = "syndieshutters";
	name = "blast shutters"
	},
/turf/open/floor/plating,
/area/template_noop)
"af" = (
/obj/machinery/door/firedoor,
/turf/open/floor/plasteel/dark/whole,
/area/template_noop)
"ag" = (
/obj/structure/window/plasma/reinforced/plastitanium,
/obj/effect/turf_decal/siding/thinplating_new/dark{
	dir = 6
	},
/obj/effect/turf_decal/tile/red/whole,
/turf/open/floor/plasteel/dark/whole,
/area/template_noop)
"ah" = (
/obj/machinery/computer/secure_data/syndie,
/obj/structure/window/reinforced/survival_pod{
	dir = 4
	},
/obj/effect/turf_decal/tile/dark/whole,
/obj/effect/turf_decal/tile/red/half/contrast{
	dir = 1
	},
/turf/open/floor/mineral/plastitanium/red,
/area/template_noop)
"ai" = (
/obj/machinery/computer/camera_advanced/shuttle_docker/syndicate,
/obj/effect/turf_decal/tile/dark/whole,
/obj/effect/turf_decal/tile/red/half/contrast{
	dir = 1
	},
/turf/open/floor/mineral/plastitanium/red,
/area/template_noop)
"aj" = (
/obj/machinery/computer/arcade/orion_trail/kobayashi{
	name = "Cybersun Industries Brand Central Shuttle Console";
	desc = "Sweet, of course there's games on the shuttle!"
	},
/obj/effect/turf_decal/tile/dark/whole,
/obj/effect/turf_decal/tile/red/half/contrast{
	dir = 1
	},
/turf/open/floor/mineral/plastitanium/red,
/area/template_noop)
"ak" = (
/obj/machinery/computer/shuttle/syndicate,
/obj/effect/turf_decal/tile/dark/whole,
/obj/effect/turf_decal/tile/red/half/contrast{
	dir = 1
	},
/turf/open/floor/mineral/plastitanium/red,
/area/template_noop)
"al" = (
/obj/machinery/computer/med_data/syndie,
/obj/structure/window/reinforced/survival_pod{
	dir = 8
	},
/obj/effect/turf_decal/tile/dark/whole,
/obj/effect/turf_decal/tile/red/half/contrast{
	dir = 1
	},
/turf/open/floor/mineral/plastitanium/red,
/area/template_noop)
"am" = (
/obj/structure/window/plasma/reinforced/plastitanium,
/obj/effect/turf_decal/siding/thinplating_new/dark{
	dir = 10
	},
/obj/effect/turf_decal/tile/red/whole,
/turf/open/floor/plasteel/dark/whole,
/area/template_noop)
"an" = (
/obj/machinery/computer/camera_advanced/syndie{
	dir = 4
	},
/obj/effect/turf_decal/tile/dark/whole,
/obj/effect/turf_decal/tile/red/half/contrast{
	dir = 8
	},
/turf/open/floor/mineral/plastitanium/red,
/area/template_noop)
"ao" = (
/obj/structure/chair/comfy/shuttle{
	dir = 8;
	name = "tactical chair"
	},
/obj/structure/window/reinforced/survival_pod{
	dir = 4
	},
/obj/effect/turf_decal/tile/dark/whole,
/obj/structure/window/reinforced/survival_pod{
	dir = 6
	},
/turf/open/floor/mineral/plastitanium/red,
/area/template_noop)
"ap" = (
/obj/structure/table/reinforced,
/obj/effect/turf_decal/tile/dark/whole,
/obj/item/radio/intercom{
	freerange = 1;
	name = "Syndicate Radio Intercom"
	},
/turf/open/floor/mineral/plastitanium/red,
/area/template_noop)
"aq" = (
/obj/structure/chair/office{
	name = "tactical swivel chair";
	dir = 1
	},
/obj/effect/turf_decal/tile/dark/whole,
/turf/open/floor/mineral/plastitanium/red,
/area/template_noop)
"ar" = (
/obj/structure/chair/comfy/shuttle{
	dir = 4;
	name = "tactical chair"
	},
/obj/structure/window/reinforced/survival_pod{
	dir = 8
	},
/obj/effect/turf_decal/tile/dark/whole,
/obj/structure/window/reinforced/survival_pod{
	dir = 10
	},
/turf/open/floor/mineral/plastitanium/red,
/area/template_noop)
"as" = (
/obj/machinery/computer/crew/syndie{
	dir = 8
	},
/obj/effect/turf_decal/tile/dark/whole,
/obj/effect/turf_decal/tile/red/half/contrast{
	dir = 4
	},
/turf/open/floor/mineral/plastitanium/red,
/area/template_noop)
"at" = (
/obj/effect/turf_decal/siding/thinplating_new/dark{
	dir = 1
	},
/obj/effect/turf_decal/siding/thinplating_new/dark,
/turf/open/floor/mineral/plastitanium,
/area/template_noop)
"au" = (
/obj/effect/turf_decal/tile/red{
	dir = 8
	},
/turf/open/floor/plasteel/dark,
/area/template_noop)
"av" = (
/obj/effect/turf_decal/tile/red/half{
	dir = 1
	},
/turf/open/floor/plasteel/dark/edge{
	dir = 1
	},
/area/template_noop)
"ax" = (
/obj/effect/turf_decal/siding/thinplating_new/dark{
	dir = 4
	},
/obj/machinery/door/airlock/external{
	req_access_txt = "150"
	},
/turf/open/floor/mineral/plastitanium,
/area/template_noop)
"ay" = (
/obj/item/radio/headset/syndicate/alt,
/obj/structure/rack,
/turf/open/floor/plasteel/dark/half,
/area/template_noop)
"az" = (
/obj/machinery/door/airlock/hatch{
	name = "Cockpit";
	req_access_txt = "150"
	},
/obj/effect/mapping_helpers/airlock/cyclelink_helper,
/turf/open/floor/plasteel/dark,
/area/template_noop)
"aA" = (
/obj/structure/window/plasma/reinforced/plastitanium,
/turf/open/floor/plating,
/area/template_noop)
"aC" = (
/obj/machinery/telecomms/allinone{
	intercept = 1
	},
/obj/effect/turf_decal/tile/bar/diagonal,
/obj/effect/turf_decal/tile/dark/diagonal{
	dir = 4
	},
/obj/effect/turf_decal/siding/thinplating_new/dark{
	dir = 4
	},
/turf/open/floor/circuit/red,
/area/template_noop)
"aD" = (
/turf/open/floor/plasteel/dark/half,
/area/template_noop)
"aE" = (
/obj/machinery/recharge_station,
/obj/effect/turf_decal/tile/bar/diagonal,
/obj/effect/turf_decal/tile/dark/diagonal{
	dir = 4
	},
/obj/effect/turf_decal/siding/thinplating_new/dark{
	dir = 8
	},
/obj/machinery/light/small{
	dir = 4
	},
/turf/open/floor/circuit/red,
/area/template_noop)
"aO" = (
/obj/machinery/porta_turret/syndicate/shuttle{
	dir = 10
	},
/turf/closed/wall/r_wall/syndicate,
/area/template_noop)
"aP" = (
/obj/effect/turf_decal/bot/left,
/obj/effect/turf_decal/siding/thinplating_new/dark,
/obj/structure/reagent_dispensers/fueltank,
/turf/open/floor/mineral/plastitanium/red,
/area/template_noop)
"aX" = (
/obj/machinery/light{
	dir = 4
	},
/turf/open/floor/plasteel/dark,
/area/template_noop)
"aY" = (
/obj/docking_port/mobile{
	dheight = 1;
	dir = 8;
	dwidth = 12;
	height = 17;
	hidden = 1;
	id = "syndicate";
	movement_force = list("KNOCKDOWN"=0,"THROW"=0);
	name = "syndicate infiltrator";
	port_direction = 4;
	width = 23
	},
/obj/effect/turf_decal/stripes/line{
	dir = 4
	},
/obj/effect/turf_decal/stripes/red/line{
	dir = 4
	},
/obj/machinery/door/poddoor{
	id = "smindicate";
	name = "outer blast door"
	},
/obj/machinery/button/door{
	id = "smindicate";
	name = "external door control";
	req_access_txt = "150";
	pixel_y = 28
	},
/obj/effect/turf_decal/siding/thinplating_new/dark{
	dir = 4
	},
/obj/structure/fans/tiny,
/turf/open/floor/mineral/plastitanium,
/area/template_noop)
"aZ" = (
/obj/effect/turf_decal/tile/red,
/turf/open/floor/plasteel/dark,
/area/template_noop)
"bg" = (
/turf/closed/wall/r_wall/syndicate/nodiagonal,
/area/template_noop)
"bi" = (
/obj/structure/rack,
/obj/item/clothing/suit/space/syndicate,
/obj/item/clothing/mask/gas/syndicate,
/obj/item/clothing/head/helmet/space/syndicate,
/obj/structure/sign/warning/vacuum/external{
	dir = 4;
	pixel_x = 32
	},
/obj/effect/turf_decal/bot/left,
/obj/effect/turf_decal/siding/thinplating_new/dark,
/turf/open/floor/mineral/plastitanium/red,
/area/template_noop)
"bo" = (
/obj/machinery/light{
	dir = 8
	},
/turf/open/floor/plasteel/dark,
/area/template_noop)
"bA" = (
/obj/machinery/sleeper/syndie,
/obj/effect/turf_decal/siding/green{
	dir = 9
	},
/obj/structure/window/reinforced/survival_pod{
	dir = 1
	},
/turf/open/floor/plasteel/mil/sterile/plain,
/area/template_noop)
"ca" = (
/obj/structure/table/reinforced,
/obj/effect/turf_decal/tile/dark/whole,
/obj/machinery/button/door{
	id = "syndieshutters";
	name = "Cockpit View Control";
	req_access_txt = "150"
	},
/turf/open/floor/mineral/plastitanium/red,
/area/template_noop)
"cb" = (
/turf/open/floor/plating,
/area/template_noop)
"cj" = (
/obj/machinery/door/airlock/hatch{
	name = "Cockpit";
	req_access_txt = "150"
	},
/obj/effect/mapping_helpers/airlock/cyclelink_helper{
	dir = 1
	},
/turf/open/floor/plasteel/dark,
/area/template_noop)
"dd" = (
/obj/item/clipboard{
	pixel_x = 4;
	pixel_y = 4
	},
/obj/item/book/manual/wiki/surgery,
/obj/item/clothing/gloves/color/latex,
/obj/item/clothing/mask/surgical,
/obj/item/clothing/suit/apron/surgical,
/obj/structure/table/reinforced,
/turf/open/floor/plasteel/anticorner{
	dir = 8
	},
/area/template_noop)
"dQ" = (
/obj/effect/turf_decal/tile/dark/whole,
/obj/effect/turf_decal/siding/thinplating_new/dark,
/obj/structure/tank_dispenser/oxygen,
/turf/open/floor/mineral/plastitanium/red,
/area/template_noop)
"er" = (
/obj/effect/turf_decal/tile/red{
	dir = 4
	},
/turf/open/floor/plasteel/dark,
/area/template_noop)
"fm" = (
/obj/effect/turf_decal/tile/green/whole/constrast,
/turf/open/floor/plasteel,
/area/template_noop)
"ia" = (
/obj/effect/turf_decal/tile/green/half/contrast,
/obj/effect/turf_decal/tile/dark/half/contrast{
	dir = 1
	},
/turf/open/floor/plasteel,
/area/template_noop)
"iM" = (
/obj/structure/sign/poster/contraband/syndicate_pistol{
	pixel_y = -32
	},
/obj/item/pickaxe/mini{
	pixel_y = 6
	},
/obj/item/pickaxe/mini,
/obj/item/flashlight/seclite,
/obj/item/flashlight/seclite,
/obj/item/extinguisher/mini,
/obj/item/extinguisher/mini,
/obj/structure/rack,
/turf/open/floor/plasteel/dark/half,
/area/template_noop)
"nw" = (
/obj/machinery/porta_turret/syndicate/shuttle{
	dir = 6
	},
/turf/closed/wall/r_wall/syndicate,
/area/template_noop)
"qE" = (
/obj/machinery/sleeper/syndie{
	dir = 8
	},
/obj/effect/turf_decal/tile/dark/half/contrast{
	dir = 4
	},
/turf/open/floor/plasteel/mil/sterile/plain,
/area/template_noop)
"rz" = (
/obj/machinery/light/small,
/turf/open/floor/mineral/plastitanium,
/area/template_noop)
"rT" = (
/obj/structure/table/reinforced,
/obj/item/storage/toolbox/mechanical{
	pixel_y = 6
	},
/obj/item/storage/toolbox/syndicate,
/obj/item/crowbar/red,
/obj/effect/turf_decal/bot/right,
/obj/effect/turf_decal/siding/thinplating_new/dark,
/turf/open/floor/mineral/plastitanium/red,
/area/template_noop)
"rV" = (
/obj/structure/rack,
/obj/effect/turf_decal/siding/green{
	dir = 5
	},
/obj/structure/window/reinforced/survival_pod{
	dir = 1
	},
/obj/item/storage/firstaid/regular{
	pixel_x = 4;
	pixel_y = 4
	},
/obj/item/storage/firstaid/fire,
/turf/open/floor/plasteel/mil/sterile/plain,
/area/template_noop)
"sr" = (
/obj/machinery/porta_turret/syndicate/shuttle{
	dir = 5
	},
/turf/closed/wall/r_wall/syndicate,
/area/template_noop)
"sI" = (
/obj/effect/turf_decal/tile/red{
	dir = 8
	},
/obj/structure/railing{
	dir = 8
	},
/turf/open/floor/plasteel/dark,
/area/template_noop)
"tD" = (
/obj/structure/sign/warning/vacuum/external{
	dir = 8;
	pixel_x = -32
	},
/obj/effect/turf_decal/bot/right,
/obj/effect/turf_decal/siding/thinplating_new/dark,
/obj/structure/reagent_dispensers/watertank,
/turf/open/floor/mineral/plastitanium/red,
/area/template_noop)
"uq" = (
/obj/machinery/porta_turret/syndicate/shuttle{
	dir = 9
	},
/turf/closed/wall/r_wall/syndicate,
/area/template_noop)
"vk" = (
/obj/machinery/door/airlock/glass{
	name = "Medbay";
	req_access_txt = "150"
	},
/turf/open/floor/plasteel/dark/side,
/area/template_noop)
"AS" = (
/obj/item/surgical_drapes,
/obj/item/retractor,
/obj/item/cautery,
/obj/structure/table/reinforced,
/obj/effect/turf_decal/tile/green/half/contrast{
	dir = 4
	},
/obj/effect/turf_decal/tile/dark/half/contrast{
	dir = 8
	},
/obj/machinery/light{
	dir = 4
	},
/turf/open/floor/plasteel,
/area/template_noop)
"BP" = (
/obj/machinery/computer/operating,
/turf/open/floor/plasteel/anticorner,
/area/template_noop)
"Cg" = (
/obj/item/scalpel{
	pixel_y = 16
	},
/obj/structure/table/reinforced,
/obj/item/bodypart/l_arm/robot{
	pixel_x = -6
	},
/obj/item/bodypart/r_arm/robot{
	pixel_x = 6
	},
/obj/item/hemostat,
/turf/open/floor/plasteel/anticorner{
	dir = 1
	},
/area/template_noop)
"Di" = (
/obj/effect/turf_decal/siding/thinplating_new/dark{
	dir = 8
	},
/obj/machinery/door/airlock/external{
	req_access_txt = "150"
	},
/turf/open/floor/mineral/plastitanium,
/area/template_noop)
"Ee" = (
/obj/structure/table/reinforced,
/obj/item/surgicaldrill{
	pixel_y = 5
	},
/obj/item/circular_saw,
/obj/item/healthanalyzer,
/turf/open/floor/plasteel/anticorner{
	dir = 4
	},
/area/template_noop)
"HA" = (
/obj/structure/tank_dispenser/oxygen,
/obj/effect/turf_decal/tile/dark/whole,
/obj/effect/turf_decal/siding/thinplating_new/dark,
/turf/open/floor/mineral/plastitanium/red,
/area/template_noop)
"In" = (
/turf/closed/wall/r_wall/syndicate,
/area/template_noop)
"Iu" = (
/obj/machinery/shower{
	dir = 4;
	name = "emergency shower"
	},
/obj/structure/mirror{
	pixel_x = -28
	},
/obj/effect/turf_decal/tile/green/half/contrast{
	dir = 8
	},
/obj/effect/turf_decal/tile/dark/half/contrast{
	dir = 4
	},
/turf/open/floor/plasteel,
/area/template_noop)
"KL" = (
/obj/effect/turf_decal/tile/green{
	dir = 1
	},
/turf/open/floor/plasteel,
/area/template_noop)
"Lg" = (
/obj/machinery/door/window/survival_pod{
	dir = 1
	},
/obj/effect/turf_decal/tile/green,
/turf/open/floor/plasteel,
/area/template_noop)
"Mb" = (
/obj/structure/sign/departments/medbay/alt{
	pixel_y = 32
	},
/turf/open/floor/plasteel/dark,
/area/template_noop)
"MG" = (
/obj/effect/turf_decal/tile/red,
/obj/structure/railing{
	dir = 4
	},
/turf/open/floor/plasteel/dark,
/area/template_noop)
"Pu" = (
/obj/effect/turf_decal/tile/red{
	dir = 1
	},
/turf/open/floor/plasteel/dark,
/area/template_noop)
"Rp" = (
/obj/structure/rack,
/obj/item/storage/firstaid/regular{
	pixel_x = 4;
	pixel_y = 4
	},
/obj/item/storage/firstaid/brute,
/obj/effect/turf_decal/tile/dark/half/contrast{
	dir = 8
	},
/turf/open/floor/plasteel/mil/sterile/plain,
/area/template_noop)
"SG" = (
/obj/effect/turf_decal/siding/thinplating_new/dark{
	dir = 8
	},
/obj/structure/fans/tiny,
/obj/machinery/door/poddoor{
	id = "smindicate";
	name = "outer blast door"
	},
/obj/machinery/button/door{
	id = "smindicate";
	name = "external door control";
	req_access_txt = "150";
	pixel_y = 28
	},
/turf/open/floor/mineral/plastitanium,
/area/template_noop)
"UL" = (
/obj/effect/turf_decal/siding/green{
	dir = 8
	},
/turf/open/floor/plasteel/mil/sterile/plain,
/area/template_noop)
"Vn" = (
/turf/open/floor/mineral/plastitanium,
/area/template_noop)
"Wq" = (
/obj/effect/turf_decal/siding/green{
	dir = 4
	},
/turf/open/floor/plasteel/mil/sterile/plain,
/area/template_noop)
"Yf" = (
/obj/structure/table/optable,
/obj/effect/turf_decal/tile/green/half/contrast{
	dir = 1
	},
/obj/effect/turf_decal/tile/dark/half/contrast,
/turf/open/floor/plasteel,
/area/template_noop)
"ZO" = (
/obj/effect/turf_decal/siding/thinplating_new/dark{
	dir = 1
	},
/obj/effect/turf_decal/siding/thinplating_new/dark,
/obj/machinery/light,
/turf/open/floor/mineral/plastitanium,
/area/template_noop)

(1,1,1) = {"
aa
aa
aa
aa
aa
aa
aa
aa
aa
aa
aa
aa
aa
uq
In
In
In
In
In
In
In
In
aO
"}
(2,1,1) = {"
aa
aa
aa
aa
aa
aa
aa
uq
bg
bg
SG
bg
bg
bg
ac
ac
ac
ac
ac
ac
ac
cb
cb
"}
(3,1,1) = {"
aa
aa
aa
aa
aa
aa
aa
bg
dQ
Vn
rz
bg
ac
ac
ac
ac
ac
ac
ac
ac
ac
cb
cb
"}
(4,1,1) = {"
aa
aa
aa
aa
aa
aa
aa
bg
bg
ax
bg
bg
ac
ac
ac
ac
ac
ac
ac
ac
ac
cb
cb
"}
(5,1,1) = {"
uq
bg
ae
ae
In
aa
aa
bg
tD
aZ
bo
af
ac
ac
ac
ac
ac
ac
ac
bg
In
In
nw
"}
(6,1,1) = {"
bg
ag
an
ZO
bg
In
aa
bg
aP
ac
Pu
af
ac
ac
bg
bg
bg
ac
ac
In
aa
aa
aa
"}
(7,1,1) = {"
ae
ah
ao
at
iM
bg
bg
bg
aA
af
bg
bg
bg
bg
bg
Rp
bg
ac
ac
In
In
In
aa
"}
(8,1,1) = {"
ae
ai
ap
at
sI
bg
aC
bg
aZ
er
bg
BP
Iu
Ee
rV
Wq
bg
ac
ac
ac
cb
cb
aa
"}
(9,1,1) = {"
ae
aj
aq
at
av
az
aD
cj
ac
ac
bg
Yf
fm
ia
Lg
KL
vk
ac
ac
ac
cb
cb
aa
"}
(10,1,1) = {"
ae
ak
ca
at
MG
bg
aE
bg
au
Pu
bg
dd
AS
Cg
bA
UL
bg
Mb
ac
ac
cb
cb
aa
"}
(11,1,1) = {"
ae
al
ar
at
ay
bg
bg
bg
aA
af
bg
bg
bg
bg
bg
qE
bg
ac
ac
In
In
In
aa
"}
(12,1,1) = {"
bg
am
as
ZO
bg
In
aa
bg
rT
ac
er
af
ac
ac
bg
bg
bg
ac
ac
In
aa
aa
aa
"}
(13,1,1) = {"
sr
bg
ae
ae
In
aa
aa
bg
bi
au
aX
af
ac
ac
ac
ac
ac
ac
ac
bg
In
In
aO
"}
(14,1,1) = {"
aa
aa
aa
aa
aa
aa
aa
bg
bg
Di
bg
bg
ac
ac
ac
ac
ac
ac
ac
ac
ac
cb
cb
"}
(15,1,1) = {"
aa
aa
aa
aa
aa
aa
aa
bg
HA
Vn
rz
bg
ac
ac
ac
ac
ac
ac
ac
ac
ac
cb
cb
"}
(16,1,1) = {"
aa
aa
aa
aa
aa
aa
aa
sr
bg
bg
aY
bg
bg
bg
ac
ac
ac
ac
ac
ac
ac
cb
cb
"}
(17,1,1) = {"
aa
aa
aa
aa
aa
aa
aa
aa
aa
aa
aa
aa
aa
sr
In
In
In
In
In
In
In
In
nw
"}
