//MAP CONVERTED BY dmm2tgm.py THIS HEADER COMMENT PREVENTS RECONVERSION, DO NOT REMOVE
"ap" = (
/obj/machinery/iv_drip,
/obj/effect/turf_decal/tile/green,
/obj/effect/turf_decal/tile/green{
	dir = 1
	},
/obj/effect/turf_decal/tile/green{
	dir = 8
	},
/obj/effect/turf_decal/tile/green,
/obj/effect/turf_decal/tile/green{
	dir = 1
	},
/obj/effect/turf_decal/tile/green{
	dir = 8
	},
/turf/open/floor/holofloor{
	icon_state = "white"
	},
/area/template_noop)
"aM" = (
/obj/effect/turf_decal/tile/yellow,
/obj/effect/turf_decal/tile/yellow{
	dir = 8
	},
/turf/open/floor/holofloor{
	icon_state = "white"
	},
/area/template_noop)
"cb" = (
/obj/structure/table/glass,
/obj/item/stack/medical/gauze,
/obj/item/cautery,
/obj/effect/turf_decal/tile/red{
	dir = 1
	},
/obj/effect/turf_decal/tile/red{
	dir = 4
	},
/turf/open/floor/holofloor{
	icon_state = "white"
	},
/area/template_noop)
"dU" = (
/obj/effect/turf_decal/tile/red,
/obj/effect/turf_decal/tile/red{
	dir = 8
	},
/obj/effect/turf_decal/tile/red{
	dir = 1
	},
/turf/open/floor/holofloor{
	icon_state = "white"
	},
/area/template_noop)
"ex" = (
/obj/effect/turf_decal/tile/yellow{
	dir = 4
	},
/obj/effect/turf_decal/tile/yellow{
	dir = 1
	},
/obj/effect/turf_decal/tile/yellow{
	dir = 8
	},
/obj/structure/table,
/obj/item/reagent_containers/glass/beaker,
/obj/item/reagent_containers/glass/beaker,
/obj/item/reagent_containers/glass/beaker,
/turf/open/floor/holofloor{
	icon_state = "white"
	},
/area/template_noop)
"eV" = (
/obj/structure/table/glass,
/obj/item/clothing/gloves/color/latex/nitrile,
/obj/item/clothing/suit/apron/surgical,
/obj/item/clothing/mask/surgical,
/obj/structure/window{
	dir = 4
	},
/obj/item/surgicaldrill,
/obj/effect/turf_decal/tile/red,
/obj/effect/turf_decal/tile/red{
	dir = 4
	},
/obj/effect/turf_decal/tile/red{
	dir = 8
	},
/turf/open/floor/holofloor{
	icon_state = "white"
	},
/area/template_noop)
"gb" = (
/obj/structure/window{
	dir = 8
	},
/obj/machinery/computer/crew{
	dir = 4
	},
/obj/effect/turf_decal/tile/blue{
	dir = 4
	},
/obj/effect/turf_decal/tile/blue{
	dir = 8
	},
/turf/open/floor/holofloor{
	icon_state = "white"
	},
/area/template_noop)
"gL" = (
/obj/structure/table/glass,
/obj/item/surgical_drapes,
/obj/item/razor,
/obj/item/hemostat,
/obj/effect/turf_decal/tile/red{
	dir = 1
	},
/obj/effect/turf_decal/tile/red{
	dir = 4
	},
/turf/open/floor/holofloor{
	icon_state = "white"
	},
/area/template_noop)
"gR" = (
/obj/structure/table,
/obj/item/clothing/neck/stethoscope,
/obj/effect/turf_decal/tile/blue{
	dir = 4
	},
/obj/effect/turf_decal/tile/blue{
	dir = 8
	},
/turf/open/floor/holofloor{
	icon_state = "white"
	},
/area/template_noop)
"ho" = (
/obj/machinery/stasis,
/obj/effect/turf_decal/tile/green,
/obj/effect/turf_decal/tile/green{
	dir = 8
	},
/obj/effect/turf_decal/tile/green,
/obj/effect/turf_decal/tile/green{
	dir = 8
	},
/turf/open/floor/holofloor{
	icon_state = "white"
	},
/area/template_noop)
"jO" = (
/obj/structure/chair/office/light{
	dir = 8
	},
/obj/effect/turf_decal/tile/blue{
	dir = 4
	},
/obj/effect/turf_decal/tile/blue{
	dir = 8
	},
/turf/open/floor/holofloor{
	icon_state = "white"
	},
/area/template_noop)
"kD" = (
/obj/effect/turf_decal/tile/blue{
	dir = 4
	},
/obj/effect/turf_decal/tile/blue{
	dir = 8
	},
/turf/open/floor/holofloor{
	icon_state = "white"
	},
/area/template_noop)
"lt" = (
/obj/effect/turf_decal/tile/blue{
	dir = 1
	},
/turf/open/floor/holofloor{
	icon_state = "white"
	},
/area/template_noop)
"lD" = (
/obj/structure/window{
	dir = 1
	},
/obj/structure/table/glass,
/obj/item/healthanalyzer,
/obj/effect/turf_decal/tile/blue{
	dir = 1
	},
/obj/effect/turf_decal/tile/blue{
	dir = 4
	},
/turf/open/floor/holofloor{
	icon_state = "white"
	},
/area/template_noop)
"lY" = (
/obj/structure/window,
/obj/effect/turf_decal/tile/blue,
/obj/effect/turf_decal/tile/blue{
	dir = 8
	},
/turf/open/floor/holofloor{
	icon_state = "white"
	},
/area/template_noop)
"my" = (
/obj/effect/turf_decal/tile/yellow{
	dir = 1
	},
/obj/effect/turf_decal/tile/yellow{
	dir = 8
	},
/obj/structure/table,
/obj/item/reagent_containers/glass/beaker/large,
/turf/open/floor/holofloor{
	icon_state = "white"
	},
/area/template_noop)
"nn" = (
/obj/structure/window{
	dir = 1
	},
/obj/effect/turf_decal/tile/blue{
	dir = 1
	},
/obj/effect/turf_decal/tile/blue{
	dir = 4
	},
/obj/item/kirbyplants{
	icon_state = "plant-21"
	},
/turf/open/floor/holofloor{
	icon_state = "white"
	},
/area/template_noop)
"oe" = (
/obj/effect/turf_decal/tile/green,
/obj/effect/turf_decal/tile/green{
	dir = 1
	},
/obj/effect/turf_decal/tile/green{
	dir = 4
	},
/obj/effect/turf_decal/tile/green,
/obj/effect/turf_decal/tile/green{
	dir = 1
	},
/obj/effect/turf_decal/tile/green{
	dir = 4
	},
/turf/open/floor/holofloor{
	icon_state = "white"
	},
/area/template_noop)
"pt" = (
/obj/structure/table,
/obj/item/flashlight/lamp,
/obj/effect/turf_decal/tile/blue{
	dir = 4
	},
/obj/effect/turf_decal/tile/blue{
	dir = 8
	},
/obj/structure/window{
	dir = 8
	},
/turf/open/floor/holofloor{
	icon_state = "white"
	},
/area/template_noop)
"rf" = (
/obj/machinery/stasis,
/obj/effect/turf_decal/tile/green,
/obj/effect/turf_decal/tile/green{
	dir = 4
	},
/obj/effect/turf_decal/tile/green{
	dir = 8
	},
/obj/effect/turf_decal/tile/green,
/obj/effect/turf_decal/tile/green{
	dir = 4
	},
/obj/effect/turf_decal/tile/green{
	dir = 8
	},
/turf/open/floor/holofloor{
	icon_state = "white"
	},
/area/template_noop)
"sx" = (
/turf/open/floor/holofloor{
	icon_state = "white"
	},
/area/template_noop)
"tf" = (
/obj/effect/turf_decal/tile/yellow,
/obj/effect/turf_decal/tile/yellow{
	dir = 1
	},
/obj/effect/turf_decal/tile/yellow{
	dir = 8
	},
/obj/structure/table,
/obj/item/storage/box/syringes,
/turf/open/floor/holofloor{
	icon_state = "white"
	},
/area/template_noop)
"tu" = (
/obj/structure/table/glass,
/obj/item/retractor,
/obj/effect/turf_decal/tile/red{
	dir = 1
	},
/obj/effect/turf_decal/tile/red{
	dir = 4
	},
/turf/open/floor/holofloor{
	icon_state = "white"
	},
/area/template_noop)
"uz" = (
/obj/structure/bed,
/obj/item/bedsheet/medical,
/obj/effect/turf_decal/tile/green{
	dir = 1
	},
/obj/effect/turf_decal/tile/green{
	dir = 4
	},
/obj/effect/turf_decal/tile/green{
	dir = 8
	},
/obj/effect/turf_decal/tile/green{
	dir = 1
	},
/obj/effect/turf_decal/tile/green{
	dir = 4
	},
/obj/effect/turf_decal/tile/green{
	dir = 8
	},
/turf/open/floor/holofloor{
	icon_state = "white"
	},
/area/template_noop)
"vF" = (
/obj/effect/turf_decal/tile/yellow,
/obj/effect/turf_decal/tile/yellow{
	dir = 4
	},
/obj/structure/table,
/obj/machinery/reagentgrinder,
/turf/open/floor/holofloor{
	icon_state = "white"
	},
/area/template_noop)
"vR" = (
/obj/machinery/shower{
	dir = 4
	},
/obj/effect/turf_decal/tile/blue{
	dir = 1
	},
/obj/effect/turf_decal/tile/blue{
	dir = 8
	},
/obj/effect/turf_decal/tile/blue,
/turf/open/floor/holofloor{
	icon_state = "white"
	},
/area/template_noop)
"wr" = (
/obj/structure/window{
	dir = 1
	},
/obj/effect/turf_decal/tile/blue{
	dir = 1
	},
/obj/effect/turf_decal/tile/blue{
	dir = 4
	},
/obj/structure/bed/roller,
/turf/open/floor/holofloor{
	icon_state = "white"
	},
/area/template_noop)
"wX" = (
/obj/structure/table,
/obj/item/folder/white,
/obj/effect/turf_decal/tile/blue{
	dir = 4
	},
/obj/effect/turf_decal/tile/blue{
	dir = 8
	},
/turf/open/floor/holofloor{
	icon_state = "white"
	},
/area/template_noop)
"yA" = (
/obj/effect/turf_decal/tile/blue{
	dir = 1
	},
/obj/effect/turf_decal/tile/blue{
	dir = 4
	},
/turf/open/floor/holofloor{
	icon_state = "white"
	},
/area/template_noop)
"yM" = (
/obj/effect/turf_decal/tile/green,
/obj/effect/turf_decal/tile/green{
	dir = 4
	},
/obj/effect/turf_decal/tile/green,
/obj/effect/turf_decal/tile/green{
	dir = 4
	},
/turf/open/floor/holofloor{
	icon_state = "white"
	},
/area/template_noop)
"zg" = (
/obj/structure/window{
	dir = 8
	},
/obj/machinery/computer/med_data{
	dir = 4
	},
/obj/effect/turf_decal/tile/blue{
	dir = 4
	},
/obj/effect/turf_decal/tile/blue{
	dir = 8
	},
/turf/open/floor/holofloor{
	icon_state = "white"
	},
/area/template_noop)
"AH" = (
/obj/machinery/door/window/westleft{
	dir = 2
	},
/obj/effect/turf_decal/tile/blue,
/obj/effect/turf_decal/tile/blue{
	dir = 8
	},
/turf/open/floor/holofloor{
	icon_state = "white"
	},
/area/template_noop)
"Bs" = (
/obj/structure/table/optable,
/obj/effect/turf_decal/tile/red,
/obj/effect/turf_decal/tile/red{
	dir = 8
	},
/turf/open/floor/holofloor{
	icon_state = "white"
	},
/area/template_noop)
"BH" = (
/obj/structure/window{
	dir = 1
	},
/obj/effect/turf_decal/tile/blue{
	dir = 1
	},
/obj/effect/turf_decal/tile/blue{
	dir = 4
	},
/obj/item/kirbyplants{
	icon_state = "plant-08"
	},
/turf/open/floor/holofloor{
	icon_state = "white"
	},
/area/template_noop)
"BW" = (
/obj/structure/closet/wardrobe/white,
/obj/effect/turf_decal/tile/blue{
	dir = 4
	},
/obj/effect/turf_decal/tile/blue{
	dir = 8
	},
/turf/open/floor/holofloor{
	icon_state = "white"
	},
/area/template_noop)
"BX" = (
/obj/machinery/computer/pandemic,
/obj/effect/turf_decal/tile/yellow,
/obj/effect/turf_decal/tile/yellow{
	dir = 4
	},
/obj/effect/turf_decal/tile/yellow{
	dir = 8
	},
/turf/open/floor/holofloor{
	icon_state = "white"
	},
/area/template_noop)
"CN" = (
/obj/effect/turf_decal/tile/blue{
	dir = 1
	},
/obj/effect/turf_decal/tile/blue{
	dir = 4
	},
/obj/effect/turf_decal/tile/blue{
	dir = 8
	},
/turf/open/floor/holofloor{
	icon_state = "white"
	},
/area/template_noop)
"CR" = (
/obj/machinery/chem_master,
/obj/effect/turf_decal/tile/yellow{
	dir = 4
	},
/obj/effect/turf_decal/tile/yellow{
	dir = 1
	},
/turf/open/floor/holofloor{
	icon_state = "white"
	},
/area/template_noop)
"CY" = (
/obj/structure/window{
	dir = 4
	},
/obj/effect/turf_decal/tile/red,
/obj/effect/turf_decal/tile/red{
	dir = 4
	},
/turf/open/floor/holofloor{
	icon_state = "white"
	},
/area/template_noop)
"FU" = (
/obj/structure/window,
/obj/effect/turf_decal/tile/blue,
/obj/effect/turf_decal/tile/blue{
	dir = 8
	},
/obj/effect/turf_decal/tile/blue{
	dir = 1
	},
/turf/open/floor/holofloor{
	icon_state = "white"
	},
/area/template_noop)
"Gw" = (
/obj/machinery/shower{
	dir = 4
	},
/obj/effect/turf_decal/tile/blue{
	dir = 1
	},
/obj/effect/turf_decal/tile/blue{
	dir = 8
	},
/turf/open/floor/holofloor{
	icon_state = "white"
	},
/area/template_noop)
"Hn" = (
/obj/effect/turf_decal/tile/blue{
	dir = 4
	},
/obj/effect/turf_decal/tile/blue{
	dir = 8
	},
/obj/structure/table,
/obj/item/paper_bin,
/obj/item/pen,
/turf/open/floor/holofloor{
	icon_state = "white"
	},
/area/template_noop)
"Ir" = (
/obj/effect/turf_decal/tile/yellow,
/obj/effect/turf_decal/tile/yellow{
	dir = 4
	},
/obj/effect/turf_decal/tile/yellow{
	dir = 1
	},
/obj/structure/table,
/obj/item/reagent_containers/dropper,
/obj/item/assembly/igniter,
/turf/open/floor/holofloor{
	icon_state = "white"
	},
/area/template_noop)
"IS" = (
/obj/effect/turf_decal/tile/green{
	dir = 1
	},
/obj/effect/turf_decal/tile/green{
	dir = 8
	},
/obj/effect/turf_decal/tile/green{
	dir = 1
	},
/obj/effect/turf_decal/tile/green{
	dir = 8
	},
/turf/open/floor/holofloor{
	icon_state = "white"
	},
/area/template_noop)
"Kz" = (
/obj/structure/window{
	dir = 1
	},
/obj/effect/turf_decal/tile/blue{
	dir = 1
	},
/obj/effect/turf_decal/tile/blue{
	dir = 4
	},
/obj/effect/turf_decal/tile/blue,
/turf/open/floor/holofloor{
	icon_state = "white"
	},
/area/template_noop)
"Me" = (
/obj/machinery/iv_drip,
/obj/effect/turf_decal/tile/green,
/obj/effect/turf_decal/tile/green{
	dir = 8
	},
/obj/effect/turf_decal/tile/green,
/obj/effect/turf_decal/tile/green{
	dir = 8
	},
/turf/open/floor/holofloor{
	icon_state = "white"
	},
/area/template_noop)
"NL" = (
/obj/structure/window{
	dir = 1
	},
/obj/structure/table/glass,
/obj/effect/turf_decal/tile/blue{
	dir = 1
	},
/obj/effect/turf_decal/tile/blue{
	dir = 4
	},
/obj/item/storage/box/masks,
/turf/open/floor/holofloor{
	icon_state = "white"
	},
/area/template_noop)
"NX" = (
/obj/effect/turf_decal/tile/blue,
/obj/effect/turf_decal/tile/blue{
	dir = 4
	},
/obj/effect/turf_decal/tile/blue{
	dir = 1
	},
/turf/open/floor/holofloor{
	icon_state = "white"
	},
/area/template_noop)
"OO" = (
/obj/machinery/computer/operating{
	dir = 4
	},
/obj/effect/turf_decal/tile/red,
/obj/effect/turf_decal/tile/red{
	dir = 8
	},
/turf/open/floor/holofloor{
	icon_state = "white"
	},
/area/template_noop)
"PG" = (
/obj/machinery/washing_machine,
/obj/effect/turf_decal/tile/blue{
	dir = 4
	},
/obj/effect/turf_decal/tile/blue{
	dir = 8
	},
/turf/open/floor/holofloor{
	icon_state = "white"
	},
/area/template_noop)
"QB" = (
/obj/structure/filingcabinet,
/obj/effect/turf_decal/tile/blue{
	dir = 4
	},
/obj/effect/turf_decal/tile/blue{
	dir = 8
	},
/turf/open/floor/holofloor{
	icon_state = "white"
	},
/area/template_noop)
"QX" = (
/obj/structure/closet/crate/freezer/blood,
/obj/structure/window{
	dir = 4
	},
/obj/effect/turf_decal/tile/red,
/obj/effect/turf_decal/tile/red{
	dir = 4
	},
/obj/effect/turf_decal/tile/red{
	dir = 1
	},
/turf/open/floor/holofloor{
	icon_state = "white"
	},
/area/template_noop)
"RC" = (
/obj/effect/turf_decal/tile/red{
	dir = 1
	},
/obj/effect/turf_decal/tile/red{
	dir = 8
	},
/turf/open/floor/holofloor{
	icon_state = "white"
	},
/area/template_noop)
"Sd" = (
/obj/structure/bed,
/obj/item/bedsheet/medical,
/obj/effect/turf_decal/tile/green{
	dir = 1
	},
/obj/effect/turf_decal/tile/green{
	dir = 4
	},
/obj/effect/turf_decal/tile/green{
	dir = 1
	},
/obj/effect/turf_decal/tile/green{
	dir = 4
	},
/turf/open/floor/holofloor{
	icon_state = "white"
	},
/area/template_noop)
"SH" = (
/obj/structure/window,
/obj/effect/turf_decal/tile/blue,
/obj/effect/turf_decal/tile/blue{
	dir = 8
	},
/obj/item/kirbyplants{
	icon_state = "plant-10"
	},
/turf/open/floor/holofloor{
	icon_state = "white"
	},
/area/template_noop)
"TX" = (
/obj/structure/window{
	dir = 1
	},
/obj/effect/turf_decal/tile/blue{
	dir = 1
	},
/obj/effect/turf_decal/tile/blue{
	dir = 4
	},
/obj/structure/table/glass,
/obj/item/storage/box/gloves{
	pixel_x = 3;
	pixel_y = 3
	},
/turf/open/floor/holofloor{
	icon_state = "white"
	},
/area/template_noop)
"TZ" = (
/obj/structure/table/glass,
/obj/item/scalpel{
	pixel_y = 10
	},
/obj/item/circular_saw,
/obj/effect/turf_decal/tile/red{
	dir = 1
	},
/obj/effect/turf_decal/tile/red{
	dir = 4
	},
/turf/open/floor/holofloor{
	icon_state = "white"
	},
/area/template_noop)
"Wq" = (
/obj/effect/turf_decal/tile/blue,
/turf/open/floor/holofloor{
	icon_state = "white"
	},
/area/template_noop)
"Xm" = (
/obj/structure/bodycontainer/morgue{
	dir = 2
	},
/obj/effect/turf_decal/tile/red{
	dir = 1
	},
/obj/effect/turf_decal/tile/red{
	dir = 4
	},
/obj/effect/turf_decal/tile/red{
	dir = 8
	},
/turf/open/floor/holofloor{
	icon_state = "white"
	},
/area/template_noop)
"Xs" = (
/obj/structure/window,
/obj/effect/turf_decal/tile/blue,
/obj/effect/turf_decal/tile/blue{
	dir = 8
	},
/obj/effect/turf_decal/tile/blue{
	dir = 4
	},
/turf/open/floor/holofloor{
	icon_state = "white"
	},
/area/template_noop)
"YH" = (
/obj/effect/turf_decal/tile/blue,
/obj/effect/turf_decal/tile/blue{
	dir = 4
	},
/turf/open/floor/holofloor{
	icon_state = "white"
	},
/area/template_noop)
"Zl" = (
/obj/machinery/computer/operating{
	dir = 8
	},
/obj/effect/turf_decal/tile/red,
/obj/effect/turf_decal/tile/red{
	dir = 8
	},
/turf/open/floor/holofloor{
	icon_state = "white"
	},
/area/template_noop)

(1,1,1) = {"
Xm
RC
dU
CN
vR
Gw
FU
uz
IS
ap
"}
(2,1,1) = {"
gL
sx
Bs
nn
Wq
lt
lY
Sd
sx
ho
"}
(3,1,1) = {"
TZ
sx
Zl
NL
Wq
lt
lY
Sd
sx
Me
"}
(4,1,1) = {"
tu
sx
OO
lD
Wq
lt
AH
oe
yM
rf
"}
(5,1,1) = {"
cb
sx
Bs
TX
Wq
lt
SH
gb
zg
pt
"}
(6,1,1) = {"
QX
CY
eV
wr
Wq
lt
lY
kD
jO
wX
"}
(7,1,1) = {"
ex
my
tf
BH
Wq
lt
AH
kD
kD
Hn
"}
(8,1,1) = {"
CR
sx
aM
yA
Wq
lt
lY
BW
kD
gR
"}
(9,1,1) = {"
Ir
vF
BX
Kz
YH
NX
Xs
PG
kD
QB
"}
