//MAP CONVERTED BY dmm2tgm.py THIS HEADER COMMENT PREVENTS RECONVERSION, DO NOT REMOVE
"a" = (
/obj/structure/table,
/turf/open/floor/holofloor/basalt,
/area/template_noop)
"c" = (
/obj/structure/window{
	dir = 1
	},
/turf/open/floor/holofloor/basalt,
/area/template_noop)
"f" = (
/turf/open/floor/holofloor/basalt,
/area/template_noop)
"q" = (
/obj/structure/table,
/obj/item/clothing/head/helmet/thunderdome,
/obj/item/clothing/suit/armor/tdome/green,
/obj/item/clothing/under/color/green,
/obj/item/holo/esword/green,
/turf/open/floor/holofloor/basalt,
/area/template_noop)
"u" = (
/obj/structure/table,
/obj/item/clothing/head/helmet/thunderdome,
/obj/item/clothing/suit/armor/tdome/red,
/obj/item/clothing/under/color/red,
/obj/item/holo/esword/red,
/turf/open/floor/holofloor/basalt,
/area/template_noop)
"H" = (
/obj/structure/window,
/turf/open/floor/holofloor/basalt,
/area/template_noop)
"I" = (
/obj/structure/table,
/obj/machinery/readybutton,
/turf/open/floor/holofloor/basalt,
/area/template_noop)

(1,1,1) = {"
I
f
f
f
H
c
f
f
f
a
"}
(2,1,1) = {"
u
f
f
f
H
c
f
f
f
q
"}
(3,1,1) = {"
u
f
f
f
H
c
f
f
f
q
"}
(4,1,1) = {"
u
f
f
f
H
c
f
f
f
q
"}
(5,1,1) = {"
u
f
f
f
H
c
f
f
f
q
"}
(6,1,1) = {"
u
f
f
f
H
c
f
f
f
q
"}
(7,1,1) = {"
u
f
f
f
H
c
f
f
f
q
"}
(8,1,1) = {"
u
f
f
f
H
c
f
f
f
q
"}
(9,1,1) = {"
a
f
f
f
H
c
f
f
f
I
"}
