//MAP CONVERTED BY dmm2tgm.py THIS HEADER COMMENT PREVENTS RECONVERSION, DO NOT REMOVE
"a" = (
/obj/effect/turf_decal/tile/neutral{
	dir = 8
	},
/obj/effect/turf_decal/tile/neutral{
	dir = 1
	},
/obj/effect/turf_decal/tile/neutral{
	dir = 4
	},
/obj/effect/turf_decal/tile/neutral,
/turf/open/floor/holofloor/dark,
/area/template_noop)
"b" = (
/obj/effect/turf_decal/tile/neutral{
	dir = 8
	},
/obj/effect/turf_decal/tile/neutral{
	dir = 1
	},
/turf/open/floor/holofloor/dark,
/area/template_noop)
"e" = (
/obj/structure/chair{
	dir = 1
	},
/obj/effect/turf_decal/tile/neutral{
	dir = 4
	},
/obj/effect/turf_decal/tile/neutral{
	dir = 8
	},
/turf/open/floor/holofloor/dark,
/area/template_noop)
"h" = (
/obj/item/gavelblock,
/obj/item/gavelhammer,
/obj/structure/table/wood,
/obj/effect/turf_decal/tile/neutral{
	dir = 8
	},
/obj/effect/turf_decal/tile/neutral,
/turf/open/floor/holofloor/dark,
/area/template_noop)
"l" = (
/obj/effect/turf_decal/tile/neutral{
	dir = 4
	},
/obj/effect/turf_decal/tile/neutral{
	dir = 8
	},
/obj/structure/table/wood,
/obj/item/reagent_containers/food/snacks/grown/poppy{
	pixel_y = 2
	},
/obj/item/reagent_containers/food/snacks/grown/poppy{
	pixel_y = 2
	},
/obj/item/reagent_containers/food/snacks/grown/poppy{
	pixel_y = 2
	},
/obj/item/reagent_containers/food/snacks/grown/poppy{
	pixel_y = 2
	},
/obj/item/reagent_containers/food/snacks/grown/poppy{
	pixel_y = 2
	},
/turf/open/floor/holofloor/dark,
/area/template_noop)
"n" = (
/obj/effect/turf_decal/tile/neutral{
	dir = 8
	},
/obj/effect/turf_decal/tile/neutral,
/obj/effect/turf_decal/tile/neutral{
	dir = 4
	},
/turf/open/floor/holofloor/dark,
/area/template_noop)
"o" = (
/obj/effect/turf_decal/tile/neutral{
	dir = 4
	},
/obj/effect/turf_decal/tile/neutral{
	dir = 8
	},
/obj/structure/table/wood,
/obj/item/paper_bin,
/turf/open/floor/holofloor/dark,
/area/template_noop)
"p" = (
/obj/item/toy/figure/chaplain,
/obj/effect/turf_decal/tile/neutral,
/obj/effect/turf_decal/tile/neutral{
	dir = 1
	},
/obj/effect/turf_decal/tile/neutral{
	dir = 4
	},
/obj/effect/turf_decal/tile/neutral{
	dir = 8
	},
/obj/structure/table/wood/fancy,
/turf/open/floor/holofloor/dark,
/area/template_noop)
"q" = (
/turf/open/floor/holofloor/chapel/bottom_left,
/area/template_noop)
"r" = (
/obj/effect/turf_decal/tile/neutral,
/obj/effect/turf_decal/tile/neutral{
	dir = 1
	},
/obj/effect/turf_decal/tile/neutral{
	dir = 4
	},
/obj/effect/turf_decal/tile/neutral{
	dir = 8
	},
/turf/open/floor/holofloor/dark,
/area/template_noop)
"t" = (
/obj/effect/turf_decal/tile/neutral{
	dir = 4
	},
/obj/effect/turf_decal/tile/neutral{
	dir = 8
	},
/turf/open/floor/holofloor/dark,
/area/template_noop)
"u" = (
/obj/structure/table/wood/fancy,
/obj/item/book/manual/wiki/security_space_law,
/obj/effect/turf_decal/tile/neutral,
/obj/effect/turf_decal/tile/neutral{
	dir = 1
	},
/obj/effect/turf_decal/tile/neutral{
	dir = 4
	},
/obj/effect/turf_decal/tile/neutral{
	dir = 8
	},
/turf/open/floor/holofloor/dark,
/area/template_noop)
"v" = (
/obj/effect/turf_decal/tile/neutral{
	dir = 4
	},
/obj/effect/turf_decal/tile/neutral{
	dir = 8
	},
/obj/structure/table/wood,
/obj/item/storage/fancy/candle_box,
/turf/open/floor/holofloor/dark,
/area/template_noop)
"w" = (
/obj/effect/turf_decal/tile/neutral{
	dir = 8
	},
/obj/effect/turf_decal/tile/neutral{
	dir = 1
	},
/obj/effect/turf_decal/tile/neutral,
/turf/open/floor/holofloor/dark,
/area/template_noop)
"x" = (
/turf/open/floor/holofloor/chapel/top_right,
/area/template_noop)
"y" = (
/obj/effect/turf_decal/tile/neutral{
	dir = 4
	},
/obj/effect/turf_decal/tile/neutral{
	dir = 8
	},
/obj/structure/table/wood,
/obj/item/reagent_containers/food/snacks/grown/harebell,
/obj/item/reagent_containers/food/snacks/grown/harebell,
/obj/item/reagent_containers/food/snacks/grown/harebell,
/obj/item/reagent_containers/food/snacks/grown/harebell,
/obj/item/reagent_containers/food/snacks/grown/harebell,
/turf/open/floor/holofloor/dark,
/area/template_noop)
"A" = (
/obj/structure/chair{
	dir = 1
	},
/turf/open/floor/holofloor/chapel/top_right,
/area/template_noop)
"B" = (
/obj/effect/turf_decal/tile/neutral,
/obj/effect/turf_decal/tile/neutral{
	dir = 4
	},
/turf/open/floor/holofloor/dark,
/area/template_noop)
"C" = (
/turf/open/floor/holofloor/dark,
/area/template_noop)
"D" = (
/obj/item/clothing/suit/chaplainsuit/bishoprobe,
/obj/effect/turf_decal/tile/neutral,
/obj/effect/turf_decal/tile/neutral{
	dir = 1
	},
/obj/effect/turf_decal/tile/neutral{
	dir = 4
	},
/obj/effect/turf_decal/tile/neutral{
	dir = 8
	},
/obj/structure/table/wood/fancy,
/turf/open/floor/holofloor/dark,
/area/template_noop)
"G" = (
/obj/effect/turf_decal/tile/neutral{
	dir = 4
	},
/obj/effect/turf_decal/tile/neutral{
	dir = 8
	},
/obj/structure/table/wood,
/obj/item/folder/red,
/obj/item/pen/red,
/turf/open/floor/holofloor/dark,
/area/template_noop)
"H" = (
/obj/effect/turf_decal/tile/neutral{
	dir = 4
	},
/obj/effect/turf_decal/tile/neutral{
	dir = 8
	},
/obj/structure/table/wood,
/obj/item/hand_labeler,
/turf/open/floor/holofloor/dark,
/area/template_noop)
"I" = (
/obj/item/clothing/head/helmet/chaplain/witchunter_hat,
/obj/effect/turf_decal/tile/neutral,
/obj/effect/turf_decal/tile/neutral{
	dir = 1
	},
/obj/effect/turf_decal/tile/neutral{
	dir = 4
	},
/obj/effect/turf_decal/tile/neutral{
	dir = 8
	},
/obj/structure/table/wood/fancy,
/turf/open/floor/holofloor/dark,
/area/template_noop)
"J" = (
/obj/structure/chair{
	dir = 1
	},
/turf/open/floor/holofloor/chapel/bottom_right,
/area/template_noop)
"K" = (
/obj/structure/chair,
/turf/open/floor/holofloor/dark,
/area/template_noop)
"N" = (
/obj/effect/turf_decal/tile/neutral{
	dir = 4
	},
/obj/effect/turf_decal/tile/neutral{
	dir = 8
	},
/obj/structure/closet/secure_closet/courtroom,
/turf/open/floor/holofloor/dark,
/area/template_noop)
"P" = (
/obj/item/clothing/suit/judgerobe,
/obj/item/clothing/head/powdered_wig,
/obj/effect/turf_decal/tile/neutral,
/obj/effect/turf_decal/tile/neutral{
	dir = 1
	},
/obj/effect/turf_decal/tile/neutral{
	dir = 4
	},
/obj/effect/turf_decal/tile/neutral{
	dir = 8
	},
/obj/structure/table/wood/fancy,
/turf/open/floor/holofloor/dark,
/area/template_noop)
"Q" = (
/obj/structure/chair{
	dir = 1
	},
/turf/open/floor/holofloor/chapel/bottom_left,
/area/template_noop)
"S" = (
/obj/structure/table/wood,
/obj/effect/turf_decal/tile/neutral{
	dir = 8
	},
/obj/effect/turf_decal/tile/neutral,
/turf/open/floor/holofloor/dark,
/area/template_noop)
"T" = (
/obj/structure/table/wood/fancy,
/obj/item/storage/book/bible,
/obj/effect/turf_decal/tile/neutral,
/obj/effect/turf_decal/tile/neutral{
	dir = 1
	},
/obj/effect/turf_decal/tile/neutral{
	dir = 4
	},
/obj/effect/turf_decal/tile/neutral{
	dir = 8
	},
/turf/open/floor/holofloor/dark,
/area/template_noop)
"U" = (
/obj/effect/turf_decal/tile/neutral{
	dir = 4
	},
/obj/effect/turf_decal/tile/neutral{
	dir = 8
	},
/obj/structure/table/wood,
/obj/item/folder/blue,
/obj/item/pen/red,
/turf/open/floor/holofloor/dark,
/area/template_noop)
"V" = (
/turf/open/floor/holofloor/chapel/bottom_right,
/area/template_noop)
"W" = (
/obj/structure/table/wood/fancy,
/obj/item/clothing/suit/chaplainsuit/nun,
/obj/item/clothing/head/nun_hood,
/obj/item/clothing/suit/chaplainsuit/holidaypriest,
/obj/effect/turf_decal/tile/neutral,
/obj/effect/turf_decal/tile/neutral{
	dir = 1
	},
/obj/effect/turf_decal/tile/neutral{
	dir = 4
	},
/obj/effect/turf_decal/tile/neutral{
	dir = 8
	},
/turf/open/floor/holofloor/dark,
/area/template_noop)
"X" = (
/obj/structure/chair{
	dir = 1
	},
/turf/open/floor/holofloor/chapel/top_left,
/area/template_noop)
"Z" = (
/turf/open/floor/holofloor/chapel/top_left,
/area/template_noop)

(1,1,1) = {"
r
Z
q
Z
Q
X
q
e
e
N
"}
(2,1,1) = {"
p
x
V
x
J
A
V
e
e
o
"}
(3,1,1) = {"
P
b
w
Z
Q
X
q
e
e
G
"}
(4,1,1) = {"
W
C
S
x
J
A
V
e
e
U
"}
(5,1,1) = {"
T
K
h
a
a
a
a
t
t
l
"}
(6,1,1) = {"
u
C
S
Z
Q
X
q
e
e
y
"}
(7,1,1) = {"
I
B
n
x
J
A
V
e
e
v
"}
(8,1,1) = {"
D
Z
q
Z
Q
X
q
e
e
H
"}
(9,1,1) = {"
r
x
V
x
J
A
V
e
e
N
"}
