//MAP CONVERTED BY dmm2tgm.py THIS HEADER COMMENT PREVENTS RECONVERSION, DO NOT REMOVE
"a" = (
/obj/structure/window/reinforced,
/turf/open/floor/holofloor/hyperspace,
/area/template_noop)
"b" = (
/obj/structure/window/reinforced{
	dir = 8
	},
/obj/machinery/computer/arcade/orion_trail/kobayashi,
/turf/open/floor/holofloor/plating,
/area/template_noop)
"d" = (
/turf/open/floor/holofloor/hyperspace,
/area/template_noop)
"e" = (
/obj/machinery/door/window/westleft{
	dir = 2;
	icon_state = "right"
	},
/turf/open/floor/holofloor/plating,
/area/template_noop)
"f" = (
/obj/structure/table/glass,
/obj/item/gun/energy/e_gun/mini/practice_phaser,
/obj/structure/window/reinforced{
	dir = 8
	},
/obj/machinery/recharger,
/turf/open/floor/holofloor/plating,
/area/template_noop)
"g" = (
/obj/structure/rack,
/obj/item/clothing/under/trek/medsci,
/obj/item/clothing/under/trek/medsci,
/obj/item/clothing/under/trek/command,
/obj/effect/turf_decal/tile/neutral{
	dir = 4
	},
/obj/effect/turf_decal/tile/neutral{
	dir = 1
	},
/obj/structure/window/reinforced{
	dir = 8
	},
/turf/open/floor/holofloor,
/area/template_noop)
"h" = (
/obj/structure/window/reinforced,
/obj/machinery/computer/station_alert{
	dir = 4
	},
/turf/open/floor/holofloor/plating,
/area/template_noop)
"i" = (
/obj/structure/chair/office{
	dir = 8
	},
/turf/open/floor/holofloor/plating,
/area/template_noop)
"j" = (
/obj/structure/window/reinforced,
/obj/machinery/mass_driver{
	dir = 1;
	id = "trektorpedo2";
	name = "photon torpedo tube"
	},
/obj/item/toy/minimeteor{
	desc = "A primitive long-range weapon, inferior to Nanotrasen's perfected bluespace artillery.";
	icon = 'icons/effects/effects.dmi';
	icon_state = "impact_laser";
	name = "photon torpedo"
	},
/turf/open/floor/holofloor/hyperspace,
/area/template_noop)
"k" = (
/obj/structure/rack,
/obj/item/clothing/under/trek/engsec,
/obj/item/clothing/under/trek/engsec,
/obj/effect/turf_decal/tile/neutral{
	dir = 4
	},
/obj/effect/turf_decal/tile/neutral{
	dir = 1
	},
/obj/structure/window/reinforced{
	dir = 4;
	layer = 2.9
	},
/turf/open/floor/holofloor,
/area/template_noop)
"l" = (
/obj/effect/turf_decal/tile/neutral{
	dir = 4
	},
/obj/effect/turf_decal/tile/neutral{
	dir = 1
	},
/obj/structure/window/reinforced{
	dir = 4;
	layer = 2.9
	},
/turf/open/floor/holofloor,
/area/template_noop)
"m" = (
/obj/structure/table,
/obj/item/folder,
/obj/item/pen/blue,
/obj/structure/window/reinforced{
	dir = 8
	},
/obj/effect/turf_decal/tile/neutral{
	dir = 1
	},
/obj/effect/turf_decal/tile/neutral{
	dir = 4
	},
/turf/open/floor/holofloor,
/area/template_noop)
"o" = (
/obj/structure/table/glass,
/obj/item/gun/energy/e_gun/mini/practice_phaser,
/obj/structure/window/reinforced{
	dir = 4
	},
/turf/open/floor/holofloor/plating,
/area/template_noop)
"p" = (
/obj/structure/table,
/obj/item/folder,
/obj/item/pen,
/obj/effect/turf_decal/tile/neutral{
	dir = 1
	},
/obj/effect/turf_decal/tile/neutral{
	dir = 4
	},
/turf/open/floor/holofloor,
/area/template_noop)
"t" = (
/obj/machinery/computer/station_alert{
	dir = 4
	},
/turf/open/floor/holofloor/plating,
/area/template_noop)
"x" = (
/obj/structure/window/reinforced,
/turf/open/floor/holofloor/plating,
/area/template_noop)
"A" = (
/obj/effect/turf_decal/tile/neutral{
	dir = 4
	},
/obj/effect/turf_decal/tile/neutral{
	dir = 1
	},
/obj/structure/window/reinforced{
	dir = 8
	},
/turf/open/floor/holofloor,
/area/template_noop)
"C" = (
/obj/structure/chair{
	dir = 1
	},
/turf/open/floor/holofloor,
/area/template_noop)
"D" = (
/obj/structure/table,
/obj/structure/window/reinforced{
	dir = 4
	},
/obj/item/folder,
/obj/item/pen/red,
/obj/effect/turf_decal/tile/neutral{
	dir = 1
	},
/obj/effect/turf_decal/tile/neutral{
	dir = 4
	},
/turf/open/floor/holofloor,
/area/template_noop)
"F" = (
/obj/machinery/computer/atmos_alert{
	dir = 8
	},
/obj/structure/window/reinforced,
/turf/open/floor/holofloor/plating,
/area/template_noop)
"I" = (
/obj/structure/table,
/turf/open/floor/holofloor/plating,
/area/template_noop)
"J" = (
/obj/machinery/computer/station_alert{
	dir = 8
	},
/turf/open/floor/holofloor/plating,
/area/template_noop)
"M" = (
/obj/structure/chair/office{
	dir = 1
	},
/turf/open/floor/holofloor/plating,
/area/template_noop)
"N" = (
/turf/open/floor/holofloor/plating,
/area/template_noop)
"R" = (
/obj/machinery/button/massdriver/indestructible{
	id = "trektorpedo1";
	layer = 3.9;
	name = "photon torpedo button";
	pixel_x = -16;
	pixel_y = -5
	},
/obj/machinery/button/massdriver/indestructible{
	id = "trektorpedo2";
	layer = 3.9;
	name = "photon torpedo button";
	pixel_x = 16;
	pixel_y = -5
	},
/obj/machinery/computer/arcade/orion_trail/kobayashi,
/turf/open/floor/holofloor/plating,
/area/template_noop)
"S" = (
/obj/effect/turf_decal/tile/neutral,
/obj/effect/turf_decal/tile/neutral{
	dir = 8
	},
/turf/open/floor/holofloor,
/area/template_noop)
"T" = (
/obj/structure/chair/comfy/beige{
	dir = 1
	},
/turf/open/floor/holofloor/plating,
/area/template_noop)
"V" = (
/obj/structure/chair/office{
	dir = 4
	},
/turf/open/floor/holofloor/plating,
/area/template_noop)
"W" = (
/obj/machinery/door/window/westleft{
	dir = 2
	},
/turf/open/floor/holofloor/plating,
/area/template_noop)
"Y" = (
/obj/structure/window/reinforced{
	dir = 4
	},
/obj/machinery/computer/arcade/orion_trail/kobayashi,
/turf/open/floor/holofloor/plating,
/area/template_noop)

(1,1,1) = {"
d
d
a
N
t
h
N
N
N
N
"}
(2,1,1) = {"
d
d
a
N
i
i
N
N
N
N
"}
(3,1,1) = {"
d
j
f
N
N
N
N
e
A
g
"}
(4,1,1) = {"
a
b
N
N
N
N
x
m
C
S
"}
(5,1,1) = {"
a
R
M
N
N
T
x
p
C
S
"}
(6,1,1) = {"
a
Y
N
N
N
I
x
D
C
S
"}
(7,1,1) = {"
d
j
o
N
N
N
N
W
l
k
"}
(8,1,1) = {"
d
d
a
N
V
V
N
N
N
N
"}
(9,1,1) = {"
d
d
a
N
J
F
N
N
N
N
"}
