//MAP CONVERTED BY dmm2tgm.py THIS HEADER COMMENT PREVENTS RECONVERSION, DO NOT REMOVE
"a" = (
/turf/open/floor/holofloor/asteroid,
/area/template_noop)
"b" = (
/obj/structure/table/wood/fancy,
/obj/item/clothing/suit/armor/riot/knight/blue,
/obj/item/clothing/head/helmet/knight/blue,
/obj/item/claymore/weak,
/turf/open/floor/holofloor/grass,
/area/template_noop)
"c" = (
/obj/structure/table/wood,
/obj/item/spear,
/turf/open/floor/holofloor/asteroid,
/area/template_noop)
"e" = (
/obj/structure/table/wood,
/obj/item/tailclub,
/obj/item/spear,
/turf/open/floor/holofloor/asteroid,
/area/template_noop)
"f" = (
/obj/structure/statue/diamond/captain,
/turf/open/floor/holofloor/grass,
/area/template_noop)
"h" = (
/obj/machinery/door/window/westleft{
	dir = 2;
	icon_state = "right"
	},
/turf/open/floor/holofloor/grass,
/area/template_noop)
"k" = (
/obj/structure/table/wood/fancy,
/obj/item/clothing/head/crown/fancy{
	pixel_y = 6
	},
/turf/open/floor/holofloor/grass,
/area/template_noop)
"l" = (
/obj/structure/table/wood,
/obj/item/scythe,
/obj/item/spear,
/turf/open/floor/holofloor/asteroid,
/area/template_noop)
"o" = (
/obj/structure/table/wood/fancy,
/obj/item/clothing/suit/armor/riot/knight/blue,
/obj/item/clothing/head/helmet/knight/blue,
/turf/open/floor/holofloor/grass,
/area/template_noop)
"p" = (
/obj/structure/table/wood,
/obj/item/melee/chainofcommand{
	name = "chain whip"
	},
/obj/item/spear,
/turf/open/floor/holofloor/asteroid,
/area/template_noop)
"r" = (
/obj/structure/chair/wood{
	dir = 1
	},
/turf/open/floor/holofloor/grass,
/area/template_noop)
"s" = (
/obj/machinery/door/window/westleft{
	dir = 2
	},
/turf/open/floor/holofloor/asteroid,
/area/template_noop)
"z" = (
/obj/structure/table/wood,
/obj/item/scythe,
/obj/item/spear,
/obj/item/melee/chainofcommand{
	name = "chain whip"
	},
/turf/open/floor/holofloor/asteroid,
/area/template_noop)
"E" = (
/obj/machinery/door/window/westleft{
	dir = 2
	},
/turf/open/floor/holofloor/grass,
/area/template_noop)
"H" = (
/turf/open/floor/holofloor/grass,
/area/template_noop)
"O" = (
/obj/structure/window/reinforced,
/turf/open/floor/holofloor/asteroid,
/area/template_noop)
"P" = (
/obj/structure/window/reinforced,
/turf/open/floor/holofloor/grass,
/area/template_noop)
"U" = (
/obj/structure/window/reinforced,
/obj/item/banner/blue,
/turf/open/floor/holofloor/asteroid,
/area/template_noop)
"Y" = (
/obj/structure/window/reinforced,
/obj/item/banner/red,
/turf/open/floor/holofloor/asteroid,
/area/template_noop)
"Z" = (
/turf/open/floor/holofloor{
	icon_state = "stairs-old"
	},
/area/template_noop)

(1,1,1) = {"
f
P
c
a
a
a
a
U
H
r
"}
(2,1,1) = {"
H
P
z
a
a
a
a
O
H
r
"}
(3,1,1) = {"
o
h
Z
a
a
a
a
O
H
r
"}
(4,1,1) = {"
b
P
p
a
a
a
a
s
H
r
"}
(5,1,1) = {"
k
P
l
a
a
a
a
O
H
r
"}
(6,1,1) = {"
b
P
e
a
a
a
a
s
H
r
"}
(7,1,1) = {"
o
E
Z
a
a
a
a
O
H
r
"}
(8,1,1) = {"
H
P
p
a
a
a
a
O
H
r
"}
(9,1,1) = {"
f
P
e
a
a
a
a
Y
H
r
"}
