//MAP CONVERTED BY dmm2tgm.py THIS HEADER COMMENT PREVENTS RECONVERSION, DO NOT REMOVE
"a" = (
/turf/open/floor/holofloor/beach,
/area/template_noop)
"b" = (
/obj/item/toy/beach_ball,
/turf/open/floor/holofloor/beach,
/area/template_noop)
"f" = (
/obj/item/toy/seashell,
/turf/open/floor/holofloor/beach,
/area/template_noop)
"i" = (
/obj/effect/holodeck_effect/mobspawner/monkey,
/turf/open/floor/holofloor/beach,
/area/template_noop)
"j" = (
/obj/effect/overlay/palmtree_r,
/turf/open/floor/holofloor/beach,
/area/template_noop)
"k" = (
/obj/item/shovel/spade,
/turf/open/floor/holofloor/beach/coast_t,
/area/template_noop)
"q" = (
/obj/structure/fluff/beach_umbrella/cap,
/turf/open/floor/holofloor/beach,
/area/template_noop)
"s" = (
/turf/open/floor/holofloor/beach/coast_t,
/area/template_noop)
"u" = (
/turf/open/floor/holofloor/carpet,
/area/template_noop)
"G" = (
/obj/effect/overlay/palmtree_l,
/obj/effect/overlay/coconut,
/turf/open/floor/holofloor/beach,
/area/template_noop)
"I" = (
/obj/item/clothing/under/color/rainbow,
/obj/item/clothing/glasses/sunglasses,
/turf/open/floor/holofloor/beach,
/area/template_noop)
"J" = (
/obj/item/reagent_containers/glass/bucket,
/turf/open/floor/holofloor/beach/coast_t,
/area/template_noop)
"M" = (
/turf/open/floor/holofloor/beach/coast_b,
/area/template_noop)
"O" = (
/obj/structure/flora/ausbushes/sparsegrass,
/turf/open/floor/holofloor/beach,
/area/template_noop)
"S" = (
/mob/living/simple_animal/crab{
	name = "Jon"
	},
/turf/open/floor/holofloor/beach/coast_t,
/area/template_noop)
"U" = (
/turf/open/floor/holofloor/beach/water,
/area/template_noop)

(1,1,1) = {"
a
a
a
a
a
a
a
s
M
U
"}
(2,1,1) = {"
a
a
a
j
a
q
a
S
M
U
"}
(3,1,1) = {"
j
i
a
a
a
u
u
s
M
U
"}
(4,1,1) = {"
a
a
a
a
I
a
a
s
M
U
"}
(5,1,1) = {"
a
a
O
a
a
u
u
s
M
U
"}
(6,1,1) = {"
a
a
a
a
j
b
a
J
M
U
"}
(7,1,1) = {"
a
G
i
a
a
a
a
k
M
U
"}
(8,1,1) = {"
O
a
a
a
i
a
f
s
M
U
"}
(9,1,1) = {"
a
a
a
a
a
a
a
s
M
U
"}
