//MAP CONVERTED BY dmm2tgm.py THIS HEADER COMMENT PREVENTS RECONVERSION, DO NOT REMOVE
"a" = (
/obj/structure/flora/ausbushes/sparsegrass,
/turf/open/floor/holofloor/grass,
/area/template_noop)
"d" = (
/obj/structure/flora/ausbushes/ppflowers,
/turf/open/floor/holofloor/grass,
/area/template_noop)
"e" = (
/obj/structure/flora/ausbushes/sunnybush,
/turf/open/floor/holofloor/grass,
/area/template_noop)
"g" = (
/obj/structure/flora/ausbushes/pointybush,
/turf/open/floor/holofloor/grass,
/area/template_noop)
"i" = (
/obj/structure/flora/ausbushes/brflowers,
/turf/open/floor/holofloor/grass,
/area/template_noop)
"j" = (
/obj/machinery/hydroponics/soil,
/obj/effect/holodeck_effect/mobspawner/pet,
/turf/open/floor/holofloor/grass,
/area/template_noop)
"m" = (
/obj/effect/holodeck_effect/mobspawner/pet,
/obj/structure/flora/ausbushes/sparsegrass,
/turf/open/floor/holofloor/grass,
/area/template_noop)
"n" = (
/obj/structure/flora/ausbushes/ywflowers,
/turf/open/floor/holofloor/grass,
/area/template_noop)
"o" = (
/obj/structure/flora/ausbushes/lavendergrass,
/turf/open/floor/holofloor/grass,
/area/template_noop)
"p" = (
/obj/effect/holodeck_effect/mobspawner/pet,
/obj/structure/flora/ausbushes/brflowers,
/turf/open/floor/holofloor/grass,
/area/template_noop)
"w" = (
/obj/machinery/hydroponics/soil,
/obj/item/cultivator,
/turf/open/floor/holofloor/grass,
/area/template_noop)
"x" = (
/obj/machinery/hydroponics/soil,
/turf/open/floor/holofloor/grass,
/area/template_noop)
"z" = (
/obj/effect/holodeck_effect/mobspawner/pet,
/turf/open/floor/holofloor/grass,
/area/template_noop)
"B" = (
/obj/structure/sink/puddle,
/turf/open/floor/holofloor/grass,
/area/template_noop)
"E" = (
/obj/item/reagent_containers/glass/bucket,
/turf/open/floor/holofloor/grass,
/area/template_noop)
"H" = (
/obj/structure/flora/ausbushes/palebush,
/turf/open/floor/holofloor/grass,
/area/template_noop)
"I" = (
/obj/item/shovel/spade{
	pixel_x = 2;
	pixel_y = -2
	},
/obj/effect/turf_decal/tile/red,
/obj/effect/turf_decal/tile/red{
	dir = 1
	},
/obj/effect/turf_decal/tile/blue{
	dir = 8
	},
/obj/effect/turf_decal/tile/blue{
	dir = 4
	},
/turf/open/floor/holofloor,
/area/template_noop)
"K" = (
/obj/structure/flora/ausbushes/reedbush,
/turf/open/floor/holofloor/grass,
/area/template_noop)
"O" = (
/obj/effect/turf_decal/tile/red,
/obj/effect/turf_decal/tile/red{
	dir = 1
	},
/obj/effect/turf_decal/tile/blue{
	dir = 8
	},
/obj/effect/turf_decal/tile/blue{
	dir = 4
	},
/turf/open/floor/holofloor,
/area/template_noop)
"P" = (
/obj/structure/flora/tree/jungle/small,
/turf/open/floor/holofloor/grass,
/area/template_noop)
"R" = (
/obj/structure/flora/ausbushes/ywflowers,
/obj/effect/holodeck_effect/mobspawner/pet,
/turf/open/floor/holofloor/grass,
/area/template_noop)
"U" = (
/obj/structure/flora/ausbushes/genericbush,
/turf/open/floor/holofloor/grass,
/area/template_noop)
"V" = (
/obj/effect/holodeck_effect/mobspawner/pet,
/obj/effect/turf_decal/tile/red,
/obj/effect/turf_decal/tile/red{
	dir = 1
	},
/obj/effect/turf_decal/tile/blue{
	dir = 8
	},
/obj/effect/turf_decal/tile/blue{
	dir = 4
	},
/turf/open/floor/holofloor,
/area/template_noop)
"W" = (
/turf/open/floor/holofloor/grass,
/area/template_noop)
"X" = (
/obj/item/trash/plate,
/obj/effect/turf_decal/tile/red,
/obj/effect/turf_decal/tile/red{
	dir = 1
	},
/obj/effect/turf_decal/tile/blue{
	dir = 8
	},
/obj/effect/turf_decal/tile/blue{
	dir = 4
	},
/turf/open/floor/holofloor,
/area/template_noop)
"Y" = (
/obj/structure/flora/ausbushes/fernybush,
/turf/open/floor/holofloor/grass,
/area/template_noop)

(1,1,1) = {"
z
W
W
W
U
W
W
U
W
a
"}
(2,1,1) = {"
W
U
W
H
z
W
H
m
e
W
"}
(3,1,1) = {"
e
z
i
W
P
d
B
x
x
W
"}
(4,1,1) = {"
W
d
e
W
W
o
i
w
j
W
"}
(5,1,1) = {"
g
p
O
V
K
e
E
j
x
U
"}
(6,1,1) = {"
W
W
X
I
W
R
W
x
x
W
"}
(7,1,1) = {"
W
e
z
H
W
U
n
B
W
H
"}
(8,1,1) = {"
U
n
U
W
B
W
z
W
Y
W
"}
(9,1,1) = {"
W
W
W
W
W
i
W
W
W
W
"}
